ATTAACATTAC->TTAACATTACG
TTAACATTACG->TAACATTACGG
TAACATTACGG->AACATTACGGA
AACATTACGGA->ACATTACGGAT
ACATTACGGAT->CATTACGGATG
CATTACGGATG->ATTACGGATGG
ATTACGGATGG->TTACGGATGGC
TTACGGATGGC->TACGGATGGCG
TACGGATGGCG->ACGGATGGCGG
ACGGATGGCGG->CGGATGGCGGG
CGGATGGCGGG->GGATGGCGGGA
GGATGGCGGGA->GATGGCGGGAC
GATGGCGGGAC->ATGGCGGGACG
ATGGCGGGACG->TGGCGGGACGT
TGGCGGGACGT->GGCGGGACGTG
GGCGGGACGTG->GCGGGACGTGC
GCGGGACGTGC->CGGGACGTGCA
CGGGACGTGCA->GGGACGTGCAA
GGGACGTGCAA->GGACGTGCAAA
GGACGTGCAAA->GACGTGCAAAA
GACGTGCAAAA->ACGTGCAAAAC
ACGTGCAAAAC->CGTGCAAAACA
CGTGCAAAACA->GTGCAAAACAT
GTGCAAAACAT->TGCAAAACATA
TGCAAAACATA->GCAAAACATAC
GCAAAACATAC->CAAAACATACA
CAAAACATACA->AAAACATACAG
AAAACATACAG->AAACATACAGG
AAACATACAGG->AACATACAGGC
AACATACAGGC->ACATACAGGCC
ACATACAGGCC->CATACAGGCCC
CATACAGGCCC->ATACAGGCCCG
ATACAGGCCCG->TACAGGCCCGT
TACAGGCCCGT->ACAGGCCCGTG
ACAGGCCCGTG->CAGGCCCGTGA
CAGGCCCGTGA->AGGCCCGTGAT
AGGCCCGTGAT->GGCCCGTGATA
GGCCCGTGATA->GCCCGTGATAT
GCCCGTGATAT->CCCGTGATATG
CCCGTGATATG->CCGTGATATGA
CCGTGATATGA->CGTGATATGAT
CGTGATATGAT->GTGATATGATG
GTGATATGATG->TGATATGATGT
TGATATGATGT->GATATGATGTT
GATATGATGTT->ATATGATGTTG
ATATGATGTTG->TATGATGTTGC
TATGATGTTGC->ATGATGTTGCT
ATGATGTTGCT->TGATGTTGCTC
TGATGTTGCTC->GATGTTGCTCG
GATGTTGCTCG->ATGTTGCTCGA
ATGTTGCTCGA->TGTTGCTCGAT
TGTTGCTCGAT->GTTGCTCGATA
GTTGCTCGATA->TTGCTCGATAC
TTGCTCGATAC->TGCTCGATACC
TGCTCGATACC->GCTCGATACCG
GCTCGATACCG->CTCGATACCGC
CTCGATACCGC->TCGATACCGCC
TCGATACCGCC->CGATACCGCCT
CGATACCGCCT->GATACCGCCTC
GATACCGCCTC->ATACCGCCTCA
ATACCGCCTCA->TACCGCCTCAA
TACCGCCTCAA->ACCGCCTCAAG
ACCGCCTCAAG->CCGCCTCAAGA
CCGCCTCAAGA->CGCCTCAAGAG,CGCCTCAAGAA
CGCCTCAAGAG->GCCTCAAGAGT
GCCTCAAGAGT->CCTCAAGAGTA
CCTCAAGAGTA->CTCAAGAGTAG
CTCAAGAGTAG->TCAAGAGTAGG
TCAAGAGTAGG->CAAGAGTAGGT
CAAGAGTAGGT->AAGAGTAGGTC
AAGAGTAGGTC->AGAGTAGGTCG
AGAGTAGGTCG->GAGTAGGTCGT
GAGTAGGTCGT->AGTAGGTCGTC
AGTAGGTCGTC->GTAGGTCGTCT
GTAGGTCGTCT->TAGGTCGTCTT
TAGGTCGTCTT->AGGTCGTCTTT
AGGTCGTCTTT->GGTCGTCTTTT
GGTCGTCTTTT->GTCGTCTTTTG
GTCGTCTTTTG->TCGTCTTTTGC
TCGTCTTTTGC->CGTCTTTTGCG
CGTCTTTTGCG->GTCTTTTGCGT
GTCTTTTGCGT->TCTTTTGCGTG
TCTTTTGCGTG->CTTTTGCGTGA
CTTTTGCGTGA->TTTTGCGTGAG
TTTTGCGTGAG->TTTGCGTGAGA
TTTGCGTGAGA->TTGCGTGAGAC
TTGCGTGAGAC->TGCGTGAGACT
TGCGTGAGACT->GCGTGAGACTA
GCGTGAGACTA->CGTGAGACTAA
CGTGAGACTAA->GTGAGACTAAA
GTGAGACTAAA->TGAGACTAAAC
TGAGACTAAAC->GAGACTAAACT
GAGACTAAACT->AGACTAAACTC
AGACTAAACTC->GACTAAACTCG
GACTAAACTCG->ACTAAACTCGA
ACTAAACTCGA->CTAAACTCGAC
CTAAACTCGAC->TAAACTCGACA
TAAACTCGACA->AAACTCGACAC
AAACTCGACAC->AACTCGACACT
AACTCGACACT->ACTCGACACTA
ACTCGACACTA->CTCGACACTAA
CTCGACACTAA->TCGACACTAAT
TCGACACTAAT->CGACACTAATA
CGACACTAATA->GACACTAATAT
GACACTAATAT->ACACTAATATC
ACACTAATATC->CACTAATATCA
CACTAATATCA->ACTAATATCAT
ACTAATATCAT->CTAATATCATG
CTAATATCATG->TAATATCATGA
TAATATCATGA->AATATCATGAC
AATATCATGAC->ATATCATGACT
ATATCATGACT->TATCATGACTC
TATCATGACTC->ATCATGACTCT
ATCATGACTCT->TCATGACTCTG
TCATGACTCTG->CATGACTCTGG
CATGACTCTGG->ATGACTCTGGG
ATGACTCTGGG->TGACTCTGGGC
TGACTCTGGGC->GACTCTGGGCG
GACTCTGGGCG->ACTCTGGGCGG
ACTCTGGGCGG->CTCTGGGCGGG
CTCTGGGCGGG->TCTGGGCGGGG
TCTGGGCGGGG->CTGGGCGGGGA
CTGGGCGGGGA->TGGGCGGGGAA
TGGGCGGGGAA->GGGCGGGGAAT
GGGCGGGGAAT->GGCGGGGAATT
GGCGGGGAATT->GCGGGGAATTT
GCGGGGAATTT->CGGGGAATTTA
CGGGGAATTTA->GGGGAATTTAA
GGGGAATTTAA->GGGAATTTAAG
GGGAATTTAAG->GGAATTTAAGG
GGAATTTAAGG->GAATTTAAGGT
GAATTTAAGGT->AATTTAAGGTT
AATTTAAGGTT->ATTTAAGGTTC
ATTTAAGGTTC->TTTAAGGTTCA
TTTAAGGTTCA->TTAAGGTTCAT
TTAAGGTTCAT->TAAGGTTCATT
TAAGGTTCATT->AAGGTTCATTG
AAGGTTCATTG->AGGTTCATTGA
AGGTTCATTGA->GGTTCATTGAG
GGTTCATTGAG->GTTCATTGAGA
GTTCATTGAGA->TTCATTGAGAC
TTCATTGAGAC->TCATTGAGACT
TCATTGAGACT->CATTGAGACTT
CATTGAGACTT->ATTGAGACTTG
ATTGAGACTTG->TTGAGACTTGA
TTGAGACTTGA->TGAGACTTGAT
TGAGACTTGAT->GAGACTTGATT
GAGACTTGATT->AGACTTGATTC
AGACTTGATTC->GACTTGATTCC
GACTTGATTCC->ACTTGATTCCA
ACTTGATTCCA->CTTGATTCCAT
CTTGATTCCAT->TTGATTCCATA
TTGATTCCATA->TGATTCCATAA
TGATTCCATAA->GATTCCATAAC
GATTCCATAAC->ATTCCATAACT
ATTCCATAACT->TTCCATAACTG
TTCCATAACTG->TCCATAACTGG
TCCATAACTGG->CCATAACTGGC
CCATAACTGGC->CATAACTGGCT
CATAACTGGCT->ATAACTGGCTT
ATAACTGGCTT->TAACTGGCTTA
TAACTGGCTTA->AACTGGCTTAG
AACTGGCTTAG->ACTGGCTTAGA
ACTGGCTTAGA->CTGGCTTAGAT
CTGGCTTAGAT->TGGCTTAGATA
TGGCTTAGATA->GGCTTAGATAA
GGCTTAGATAA->GCTTAGATAAT
GCTTAGATAAT->CTTAGATAATC
CTTAGATAATC->TTAGATAATCC
TTAGATAATCC->TAGATAATCCA
TAGATAATCCA->AGATAATCCAG
AGATAATCCAG->GATAATCCAGG
GATAATCCAGG->ATAATCCAGGC
ATAATCCAGGC->TAATCCAGGCG
TAATCCAGGCG->AATCCAGGCGT
AATCCAGGCGT->ATCCAGGCGTC
ATCCAGGCGTC->TCCAGGCGTCC
TCCAGGCGTCC->CCAGGCGTCCC
CCAGGCGTCCC->CAGGCGTCCCG
CAGGCGTCCCG->AGGCGTCCCGT
AGGCGTCCCGT->GGCGTCCCGTC
GGCGTCCCGTC->GCGTCCCGTCG
GCGTCCCGTCG->CGTCCCGTCGC
CGTCCCGTCGC->GTCCCGTCGCA
GTCCCGTCGCA->TCCCGTCGCAC
TCCCGTCGCAC->CCCGTCGCACC
CCCGTCGCACC->CCGTCGCACCG
CCGTCGCACCG->CGTCGCACCGA
CGTCGCACCGA->GTCGCACCGAG
GTCGCACCGAG->TCGCACCGAGA
TCGCACCGAGA->CGCACCGAGAT
CGCACCGAGAT->GCACCGAGATT
GCACCGAGATT->CACCGAGATTG
CACCGAGATTG->ACCGAGATTGC
ACCGAGATTGC->CCGAGATTGCG
CCGAGATTGCG->CGAGATTGCGG
CGAGATTGCGG->GAGATTGCGGA
GAGATTGCGGA->AGATTGCGGAT
AGATTGCGGAT->GATTGCGGATA
GATTGCGGATA->ATTGCGGATAA
ATTGCGGATAA->TTGCGGATAAA
TTGCGGATAAA->TGCGGATAAAT
TGCGGATAAAT->GCGGATAAATT
GCGGATAAATT->CGGATAAATTG
CGGATAAATTG->GGATAAATTGA
GGATAAATTGA->GATAAATTGAA
GATAAATTGAA->ATAAATTGAAT
ATAAATTGAAT->TAAATTGAATC
TAAATTGAATC->AAATTGAATCA
AAATTGAATCA->AATTGAATCAA
AATTGAATCAA->ATTGAATCAAA
ATTGAATCAAA->TTGAATCAAAT
TTGAATCAAAT->TGAATCAAATC
TGAATCAAATC->GAATCAAATCA
GAATCAAATCA->AATCAAATCAA
AATCAAATCAA->ATCAAATCAAA
ATCAAATCAAA->TCAAATCAAAT
TCAAATCAAAT->CAAATCAAATG
CAAATCAAATG->AAATCAAATGC
AAATCAAATGC->AATCAAATGCT
AATCAAATGCT->ATCAAATGCTT
ATCAAATGCTT->TCAAATGCTTA
TCAAATGCTTA->CAAATGCTTAC
CAAATGCTTAC->AAATGCTTACC
AAATGCTTACC->AATGCTTACCT
AATGCTTACCT->ATGCTTACCTA
ATGCTTACCTA->TGCTTACCTAT
TGCTTACCTAT->GCTTACCTATA
GCTTACCTATA->CTTACCTATAC
CTTACCTATAC->TTACCTATACG
TTACCTATACG->TACCTATACGG
TACCTATACGG->ACCTATACGGA
ACCTATACGGA->CCTATACGGAC
CCTATACGGAC->CTATACGGACG
CTATACGGACG->TATACGGACGC
TATACGGACGC->ATACGGACGCC
ATACGGACGCC->TACGGACGCCC
TACGGACGCCC->ACGGACGCCCA
ACGGACGCCCA->CGGACGCCCAA
CGGACGCCCAA->GGACGCCCAAT
GGACGCCCAAT->GACGCCCAATG
GACGCCCAATG->ACGCCCAATGG
ACGCCCAATGG->CGCCCAATGGG
CGCCCAATGGG->GCCCAATGGGC
GCCCAATGGGC->CCCAATGGGCT
CCCAATGGGCT->CCAATGGGCTA
CCAATGGGCTA->CAATGGGCTAC
CAATGGGCTAC->AATGGGCTACT
AATGGGCTACT->ATGGGCTACTA
ATGGGCTACTA->TGGGCTACTAA
TGGGCTACTAA->GGGCTACTAAA
GGGCTACTAAA->GGCTACTAAAA
GGCTACTAAAA->GCTACTAAAAC
GCTACTAAAAC->CTACTAAAACA
CTACTAAAACA->TACTAAAACAT
TACTAAAACAT->ACTAAAACATA
ACTAAAACATA->CTAAAACATAG
CTAAAACATAG->TAAAACATAGG
TAAAACATAGG->AAAACATAGGA
AAAACATAGGA->AAACATAGGAT
AAACATAGGAT->AACATAGGATG
AACATAGGATG->ACATAGGATGC
ACATAGGATGC->CATAGGATGCG
CATAGGATGCG->ATAGGATGCGT
ATAGGATGCGT->TAGGATGCGTC
TAGGATGCGTC->AGGATGCGTCA
AGGATGCGTCA->GGATGCGTCAA
GGATGCGTCAA->GATGCGTCAAG
GATGCGTCAAG->ATGCGTCAAGC
ATGCGTCAAGC->TGCGTCAAGCA
TGCGTCAAGCA->GCGTCAAGCAA
GCGTCAAGCAA->CGTCAAGCAAA
CGTCAAGCAAA->GTCAAGCAAAA
GTCAAGCAAAA->TCAAGCAAAAT
TCAAGCAAAAT->CAAGCAAAATT
CAAGCAAAATT->AAGCAAAATTG
AAGCAAAATTG->AGCAAAATTGC
AGCAAAATTGC->GCAAAATTGCT
GCAAAATTGCT->CAAAATTGCTA
CAAAATTGCTA->AAAATTGCTAT
AAAATTGCTAT->AAATTGCTATA
AAATTGCTATA->AATTGCTATAG
AATTGCTATAG->ATTGCTATAGT
ATTGCTATAGT->TTGCTATAGTC
TTGCTATAGTC->TGCTATAGTCT
TGCTATAGTCT->GCTATAGTCTA
GCTATAGTCTA->CTATAGTCTAA
CTATAGTCTAA->TATAGTCTAAA
TATAGTCTAAA->ATAGTCTAAAA
ATAGTCTAAAA->TAGTCTAAAAA
TAGTCTAAAAA->AGTCTAAAAAA
AGTCTAAAAAA->GTCTAAAAAAA
GTCTAAAAAAA->TCTAAAAAAAT
TCTAAAAAAAT->CTAAAAAAATG
CTAAAAAAATG->TAAAAAAATGC
TAAAAAAATGC->AAAAAAATGCT
AAAAAAATGCT->AAAAAATGCTG
AAAAAATGCTG->AAAAATGCTGG
AAAAATGCTGG->AAAATGCTGGA
AAAATGCTGGA->AAATGCTGGAG
AAATGCTGGAG->AATGCTGGAGC
AATGCTGGAGC->ATGCTGGAGCT
ATGCTGGAGCT->TGCTGGAGCTT
TGCTGGAGCTT->GCTGGAGCTTG
GCTGGAGCTTG->CTGGAGCTTGA
CTGGAGCTTGA->TGGAGCTTGAC
TGGAGCTTGAC->GGAGCTTGACC
GGAGCTTGACC->GAGCTTGACCG
GAGCTTGACCG->AGCTTGACCGG
AGCTTGACCGG->GCTTGACCGGT
GCTTGACCGGT->CTTGACCGGTA
CTTGACCGGTA->TTGACCGGTAA
TTGACCGGTAA->TGACCGGTAAA
TGACCGGTAAA->GACCGGTAAAG
GACCGGTAAAG->ACCGGTAAAGG
ACCGGTAAAGG->CCGGTAAAGGC
CCGGTAAAGGC->CGGTAAAGGCG
CGGTAAAGGCG->GGTAAAGGCGG
GGTAAAGGCGG->GTAAAGGCGGG
GTAAAGGCGGG->TAAAGGCGGGA
TAAAGGCGGGA->AAAGGCGGGAC
AAAGGCGGGAC->AAGGCGGGACC
AAGGCGGGACC->AGGCGGGACCT
AGGCGGGACCT->GGCGGGACCTA
GGCGGGACCTA->GCGGGACCTAG
GCGGGACCTAG->CGGGACCTAGG
CGGGACCTAGG->GGGACCTAGGC
GGGACCTAGGC->GGACCTAGGCG
GGACCTAGGCG->GACCTAGGCGA
GACCTAGGCGA->ACCTAGGCGAT
ACCTAGGCGAT->CCTAGGCGATC
CCTAGGCGATC->CTAGGCGATCG
CTAGGCGATCG->TAGGCGATCGC
TAGGCGATCGC->AGGCGATCGCT
AGGCGATCGCT->GGCGATCGCTC
GGCGATCGCTC->GCGATCGCTCG
GCGATCGCTCG->CGATCGCTCGT
CGATCGCTCGT->GATCGCTCGTA
GATCGCTCGTA->ATCGCTCGTAC
ATCGCTCGTAC->TCGCTCGTACG
TCGCTCGTACG->CGCTCGTACGC
CGCTCGTACGC->GCTCGTACGCC
GCTCGTACGCC->CTCGTACGCCG
CTCGTACGCCG->TCGTACGCCGC
TCGTACGCCGC->CGTACGCCGCG
CGTACGCCGCG->GTACGCCGCGA
GTACGCCGCGA->TACGCCGCGAT
TACGCCGCGAT->ACGCCGCGATA
ACGCCGCGATA->CGCCGCGATAC
CGCCGCGATAC->GCCGCGATACA
GCCGCGATACA->CCGCGATACAC
CCGCGATACAC->CGCGATACACG
CGCGATACACG->GCGATACACGA
GCGATACACGA->CGATACACGAC
CGATACACGAC->GATACACGACC
GATACACGACC->ATACACGACCG
ATACACGACCG->TACACGACCGT
TACACGACCGT->ACACGACCGTT
ACACGACCGTT->CACGACCGTTA
CACGACCGTTA->ACGACCGTTAG
ACGACCGTTAG->CGACCGTTAGT
CGACCGTTAGT->GACCGTTAGTC
GACCGTTAGTC->ACCGTTAGTCC
ACCGTTAGTCC->CCGTTAGTCCG
CCGTTAGTCCG->CGTTAGTCCGC
CGTTAGTCCGC->GTTAGTCCGCG
GTTAGTCCGCG->TTAGTCCGCGC
TTAGTCCGCGC->TAGTCCGCGCC
TAGTCCGCGCC->AGTCCGCGCCT
AGTCCGCGCCT->GTCCGCGCCTA
GTCCGCGCCTA->TCCGCGCCTAT
TCCGCGCCTAT->CCGCGCCTATG
CCGCGCCTATG->CGCGCCTATGT
CGCGCCTATGT->GCGCCTATGTT
GCGCCTATGTT->CGCCTATGTTC
CGCCTATGTTC->GCCTATGTTCT
GCCTATGTTCT->CCTATGTTCTT
CCTATGTTCTT->CTATGTTCTTC
CTATGTTCTTC->TATGTTCTTCA
TATGTTCTTCA->ATGTTCTTCAC
ATGTTCTTCAC->TGTTCTTCACG
TGTTCTTCACG->GTTCTTCACGC
GTTCTTCACGC->TTCTTCACGCT
TTCTTCACGCT->TCTTCACGCTA
TCTTCACGCTA->CTTCACGCTAG
CTTCACGCTAG->TTCACGCTAGG
TTCACGCTAGG->TCACGCTAGGT
TCACGCTAGGT->CACGCTAGGTG
CACGCTAGGTG->ACGCTAGGTGC
ACGCTAGGTGC->CGCTAGGTGCC
CGCTAGGTGCC->GCTAGGTGCCA
GCTAGGTGCCA->CTAGGTGCCAG
CTAGGTGCCAG->TAGGTGCCAGC
TAGGTGCCAGC->AGGTGCCAGCC
AGGTGCCAGCC->GGTGCCAGCCC
GGTGCCAGCCC->GTGCCAGCCCC
GTGCCAGCCCC->TGCCAGCCCCG
TGCCAGCCCCG->GCCAGCCCCGG
GCCAGCCCCGG->CCAGCCCCGGT
CCAGCCCCGGT->CAGCCCCGGTC
CAGCCCCGGTC->AGCCCCGGTCA
AGCCCCGGTCA->GCCCCGGTCAA
GCCCCGGTCAA->CCCCGGTCAAA
CCCCGGTCAAA->CCCGGTCAAAT
CCCGGTCAAAT->CCGGTCAAATA
CCGGTCAAATA->CGGTCAAATAC
CGGTCAAATAC->GGTCAAATACT
GGTCAAATACT->GTCAAATACTT
GTCAAATACTT->TCAAATACTTA
TCAAATACTTA->CAAATACTTAT
CAAATACTTAT->AAATACTTATA
AAATACTTATA->AATACTTATAC
AATACTTATAC->ATACTTATACC
ATACTTATACC->TACTTATACCT
TACTTATACCT->ACTTATACCTG
ACTTATACCTG->CTTATACCTGG
CTTATACCTGG->TTATACCTGGC
TTATACCTGGC->TATACCTGGCG
TATACCTGGCG->ATACCTGGCGG
ATACCTGGCGG->TACCTGGCGGA
TACCTGGCGGA->ACCTGGCGGAC
ACCTGGCGGAC->CCTGGCGGACT
CCTGGCGGACT->CTGGCGGACTT
CTGGCGGACTT->TGGCGGACTTC
TGGCGGACTTC->GGCGGACTTCG
GGCGGACTTCG->GCGGACTTCGG
GCGGACTTCGG->CGGACTTCGGA
CGGACTTCGGA->GGACTTCGGAC
GGACTTCGGAC->GACTTCGGACA
GACTTCGGACA->ACTTCGGACAG
ACTTCGGACAG->CTTCGGACAGC
CTTCGGACAGC->TTCGGACAGCT
TTCGGACAGCT->TCGGACAGCTG
TCGGACAGCTG->CGGACAGCTGT
CGGACAGCTGT->GGACAGCTGTG
GGACAGCTGTG->GACAGCTGTGC
GACAGCTGTGC->ACAGCTGTGCA
ACAGCTGTGCA->CAGCTGTGCAG
CAGCTGTGCAG->AGCTGTGCAGT
AGCTGTGCAGT->GCTGTGCAGTG
GCTGTGCAGTG->CTGTGCAGTGG
CTGTGCAGTGG->TGTGCAGTGGA
TGTGCAGTGGA->GTGCAGTGGAC
GTGCAGTGGAC->TGCAGTGGACG
TGCAGTGGACG->GCAGTGGACGC
GCAGTGGACGC->CAGTGGACGCA
CAGTGGACGCA->AGTGGACGCAG
AGTGGACGCAG->GTGGACGCAGC
GTGGACGCAGC->TGGACGCAGCT
TGGACGCAGCT->GGACGCAGCTG
GGACGCAGCTG->GACGCAGCTGC
GACGCAGCTGC->ACGCAGCTGCG
ACGCAGCTGCG->CGCAGCTGCGT
CGCAGCTGCGT->GCAGCTGCGTC
GCAGCTGCGTC->CAGCTGCGTCG
CAGCTGCGTCG->AGCTGCGTCGA
AGCTGCGTCGA->GCTGCGTCGAA
GCTGCGTCGAA->CTGCGTCGAAA
CTGCGTCGAAA->TGCGTCGAAAC
TGCGTCGAAAC->GCGTCGAAACT
GCGTCGAAACT->CGTCGAAACTT
CGTCGAAACTT->GTCGAAACTTT
GTCGAAACTTT->TCGAAACTTTT
TCGAAACTTTT->CGAAACTTTTT
CGAAACTTTTT->GAAACTTTTTT
GAAACTTTTTT->AAACTTTTTTA
AAACTTTTTTA->AACTTTTTTAG
AACTTTTTTAG->ACTTTTTTAGT
ACTTTTTTAGT->CTTTTTTAGTC
CTTTTTTAGTC->TTTTTTAGTCC
TTTTTTAGTCC->TTTTTAGTCCC
TTTTTAGTCCC->TTTTAGTCCCT
TTTTAGTCCCT->TTTAGTCCCTC
TTTAGTCCCTC->TTAGTCCCTCC
TTAGTCCCTCC->TAGTCCCTCCT
TAGTCCCTCCT->AGTCCCTCCTA
AGTCCCTCCTA->GTCCCTCCTAT
GTCCCTCCTAT->TCCCTCCTATG
TCCCTCCTATG->CCCTCCTATGA
CCCTCCTATGA->CCTCCTATGAG
CCTCCTATGAG->CTCCTATGAGT
CTCCTATGAGT->TCCTATGAGTG
TCCTATGAGTG->CCTATGAGTGG
CCTATGAGTGG->CTATGAGTGGT
CTATGAGTGGT->TATGAGTGGTG
TATGAGTGGTG->ATGAGTGGTGT
ATGAGTGGTGT->TGAGTGGTGTG
TGAGTGGTGTG->GAGTGGTGTGT
GAGTGGTGTGT->AGTGGTGTGTC
AGTGGTGTGTC->GTGGTGTGTCA
GTGGTGTGTCA->TGGTGTGTCAT
TGGTGTGTCAT->GGTGTGTCATA
GGTGTGTCATA->GTGTGTCATAC
GTGTGTCATAC->TGTGTCATACC
TGTGTCATACC->GTGTCATACCG
GTGTCATACCG->TGTCATACCGT
TGTCATACCGT->GTCATACCGTC
GTCATACCGTC->TCATACCGTCT
TCATACCGTCT->CATACCGTCTC
CATACCGTCTC->ATACCGTCTCC
ATACCGTCTCC->TACCGTCTCCA
TACCGTCTCCA->ACCGTCTCCAT
ACCGTCTCCAT->CCGTCTCCATT
CCGTCTCCATT->CGTCTCCATTT
CGTCTCCATTT->GTCTCCATTTT
GTCTCCATTTT->TCTCCATTTTA
TCTCCATTTTA->CTCCATTTTAA
CTCCATTTTAA->TCCATTTTAAA
TCCATTTTAAA->CCATTTTAAAC
CCATTTTAAAC->CATTTTAAACC
CATTTTAAACC->ATTTTAAACCC
ATTTTAAACCC->TTTTAAACCCG
TTTTAAACCCG->TTTAAACCCGA
TTTAAACCCGA->TTAAACCCGAA
TTAAACCCGAA->TAAACCCGAAA
TAAACCCGAAA->AAACCCGAAAG
AAACCCGAAAG->AACCCGAAAGC
AACCCGAAAGC->ACCCGAAAGCC
ACCCGAAAGCC->CCCGAAAGCCG
CCCGAAAGCCG->CCGAAAGCCGT
CCGAAAGCCGT->CGAAAGCCGTG
CGAAAGCCGTG->GAAAGCCGTGC
GAAAGCCGTGC->AAAGCCGTGCG
AAAGCCGTGCG->AAGCCGTGCGC
AAGCCGTGCGC->AGCCGTGCGCA
AGCCGTGCGCA->GCCGTGCGCAC
GCCGTGCGCAC->CCGTGCGCACG
CCGTGCGCACG->CGTGCGCACGG
CGTGCGCACGG->GTGCGCACGGC
GTGCGCACGGC->TGCGCACGGCA
TGCGCACGGCA->GCGCACGGCAT
GCGCACGGCAT->CGCACGGCATT
CGCACGGCATT->GCACGGCATTT
GCACGGCATTT->CACGGCATTTA
CACGGCATTTA->ACGGCATTTAA
ACGGCATTTAA->CGGCATTTAAG
CGGCATTTAAG->GGCATTTAAGT
GGCATTTAAGT->GCATTTAAGTG
GCATTTAAGTG->CATTTAAGTGA
CATTTAAGTGA->ATTTAAGTGAA
ATTTAAGTGAA->TTTAAGTGAAA
TTTAAGTGAAA->TTAAGTGAAAA
TTAAGTGAAAA->TAAGTGAAAAC
TAAGTGAAAAC->AAGTGAAAACT
AAGTGAAAACT->AGTGAAAACTG
AGTGAAAACTG->GTGAAAACTGA
GTGAAAACTGA->TGAAAACTGAG
TGAAAACTGAG->GAAAACTGAGC
GAAAACTGAGC->AAAACTGAGCG
AAAACTGAGCG->AAACTGAGCGG
AAACTGAGCGG->AACTGAGCGGC
AACTGAGCGGC->ACTGAGCGGCG
ACTGAGCGGCG->CTGAGCGGCGA
CTGAGCGGCGA->TGAGCGGCGAC
TGAGCGGCGAC->GAGCGGCGACC
GAGCGGCGACC->AGCGGCGACCG
AGCGGCGACCG->GCGGCGACCGG
GCGGCGACCGG->CGGCGACCGGA
CGGCGACCGGA->GGCGACCGGAC
GGCGACCGGAC->GCGACCGGACG
GCGACCGGACG->CGACCGGACGG
CGACCGGACGG->GACCGGACGGT
GACCGGACGGT->ACCGGACGGTC
ACCGGACGGTC->CCGGACGGTCG
CCGGACGGTCG->CGGACGGTCGA
CGGACGGTCGA->GGACGGTCGAT
GGACGGTCGAT->GACGGTCGATA
GACGGTCGATA->ACGGTCGATAC
ACGGTCGATAC->CGGTCGATACA
CGGTCGATACA->GGTCGATACAG
GGTCGATACAG->GTCGATACAGC
GTCGATACAGC->TCGATACAGCC
TCGATACAGCC->CGATACAGCCG
CGATACAGCCG->GATACAGCCGA
GATACAGCCGA->ATACAGCCGAC
ATACAGCCGAC->TACAGCCGACT
TACAGCCGACT->ACAGCCGACTG
ACAGCCGACTG->CAGCCGACTGG
CAGCCGACTGG->AGCCGACTGGT
AGCCGACTGGT->GCCGACTGGTG
GCCGACTGGTG->CCGACTGGTGG
CCGACTGGTGG->CGACTGGTGGT
CGACTGGTGGT->GACTGGTGGTT
GACTGGTGGTT->ACTGGTGGTTC
ACTGGTGGTTC->CTGGTGGTTCT
CTGGTGGTTCT->TGGTGGTTCTG
TGGTGGTTCTG->GGTGGTTCTGA
GGTGGTTCTGA->GTGGTTCTGAC
GTGGTTCTGAC->TGGTTCTGACG
TGGTTCTGACG->GGTTCTGACGG
GGTTCTGACGG->GTTCTGACGGT
GTTCTGACGGT->TTCTGACGGTC
TTCTGACGGTC->TCTGACGGTCT
TCTGACGGTCT->CTGACGGTCTG
CTGACGGTCTG->TGACGGTCTGG
TGACGGTCTGG->GACGGTCTGGT
GACGGTCTGGT->ACGGTCTGGTA
ACGGTCTGGTA->CGGTCTGGTAT
CGGTCTGGTAT->GGTCTGGTATT
GGTCTGGTATT->GTCTGGTATTC
GTCTGGTATTC->TCTGGTATTCT
TCTGGTATTCT->CTGGTATTCTT
CTGGTATTCTT->TGGTATTCTTG
TGGTATTCTTG->GGTATTCTTGC
GGTATTCTTGC->GTATTCTTGCT
GTATTCTTGCT->TATTCTTGCTA
TATTCTTGCTA->ATTCTTGCTAT
ATTCTTGCTAT->TTCTTGCTATC
TTCTTGCTATC->TCTTGCTATCC
TCTTGCTATCC->CTTGCTATCCT
CTTGCTATCCT->TTGCTATCCTG
TTGCTATCCTG->TGCTATCCTGG
TGCTATCCTGG->GCTATCCTGGC
GCTATCCTGGC->CTATCCTGGCT
CTATCCTGGCT->TATCCTGGCTC
TATCCTGGCTC->ATCCTGGCTCC
ATCCTGGCTCC->TCCTGGCTCCT
TCCTGGCTCCT->CCTGGCTCCTA
CCTGGCTCCTA->CTGGCTCCTAT
CTGGCTCCTAT->TGGCTCCTATT
TGGCTCCTATT->GGCTCCTATTT
GGCTCCTATTT->GCTCCTATTTG
GCTCCTATTTG->CTCCTATTTGT
CTCCTATTTGT->TCCTATTTGTG
TCCTATTTGTG->CCTATTTGTGA
CCTATTTGTGA->CTATTTGTGAG
CTATTTGTGAG->TATTTGTGAGC
TATTTGTGAGC->ATTTGTGAGCC
ATTTGTGAGCC->TTTGTGAGCCG
TTTGTGAGCCG->TTGTGAGCCGC
TTGTGAGCCGC->TGTGAGCCGCC
TGTGAGCCGCC->GTGAGCCGCCC
GTGAGCCGCCC->TGAGCCGCCCT
TGAGCCGCCCT->GAGCCGCCCTT
GAGCCGCCCTT->AGCCGCCCTTA
AGCCGCCCTTA->GCCGCCCTTAA
GCCGCCCTTAA->CCGCCCTTAAA
CCGCCCTTAAA->CGCCCTTAAAG
CGCCCTTAAAG->GCCCTTAAAGG
GCCCTTAAAGG->CCCTTAAAGGC
CCCTTAAAGGC->CCTTAAAGGCG
CCTTAAAGGCG->CTTAAAGGCGG
CTTAAAGGCGG->TTAAAGGCGGA
TTAAAGGCGGA->TAAAGGCGGAG
TAAAGGCGGAG->AAAGGCGGAGC
AAAGGCGGAGC->AAGGCGGAGCG
AAGGCGGAGCG->AGGCGGAGCGG
AGGCGGAGCGG->GGCGGAGCGGG
GGCGGAGCGGG->GCGGAGCGGGG
GCGGAGCGGGG->CGGAGCGGGGC
CGGAGCGGGGC->GGAGCGGGGCA
GGAGCGGGGCA->GAGCGGGGCAT
GAGCGGGGCAT->AGCGGGGCATG
AGCGGGGCATG->GCGGGGCATGA
GCGGGGCATGA->CGGGGCATGAA
CGGGGCATGAA->GGGGCATGAAA
GGGGCATGAAA->GGGCATGAAAA
GGGCATGAAAA->GGCATGAAAAG
GGCATGAAAAG->GCATGAAAAGA
GCATGAAAAGA->CATGAAAAGAT
CATGAAAAGAT->ATGAAAAGATA
ATGAAAAGATA->TGAAAAGATAG
TGAAAAGATAG->GAAAAGATAGG
GAAAAGATAGG->AAAAGATAGGG
AAAAGATAGGG->AAAGATAGGGA
AAAGATAGGGA->AAGATAGGGAC
AAGATAGGGAC->AGATAGGGACT
AGATAGGGACT->GATAGGGACTC
GATAGGGACTC->ATAGGGACTCC
ATAGGGACTCC->TAGGGACTCCA
TAGGGACTCCA->AGGGACTCCAT
AGGGACTCCAT->GGGACTCCATC
GGGACTCCATC->GGACTCCATCG
GGACTCCATCG->GACTCCATCGG
GACTCCATCGG->ACTCCATCGGC
ACTCCATCGGC->CTCCATCGGCA
CTCCATCGGCA->TCCATCGGCAG
TCCATCGGCAG->CCATCGGCAGA
CCATCGGCAGA->CATCGGCAGAA
CATCGGCAGAA->ATCGGCAGAAA
ATCGGCAGAAA->TCGGCAGAAAA
TCGGCAGAAAA->CGGCAGAAAAC
CGGCAGAAAAC->GGCAGAAAACG
GGCAGAAAACG->GCAGAAAACGA
GCAGAAAACGA->CAGAAAACGAG
CAGAAAACGAG->AGAAAACGAGC
AGAAAACGAGC->GAAAACGAGCA
GAAAACGAGCA->AAAACGAGCAA
AAAACGAGCAA->AAACGAGCAAT
AAACGAGCAAT->AACGAGCAATC
AACGAGCAATC->ACGAGCAATCT
ACGAGCAATCT->CGAGCAATCTT
CGAGCAATCTT->GAGCAATCTTA
GAGCAATCTTA->AGCAATCTTAA
AGCAATCTTAA->GCAATCTTAAT
GCAATCTTAAT->CAATCTTAATC
CAATCTTAATC->AATCTTAATCG
AATCTTAATCG->ATCTTAATCGG
ATCTTAATCGG->TCTTAATCGGC
TCTTAATCGGC->CTTAATCGGCA
CTTAATCGGCA->TTAATCGGCAA
TTAATCGGCAA->TAATCGGCAAC
TAATCGGCAAC->AATCGGCAACG
AATCGGCAACG->ATCGGCAACGG
ATCGGCAACGG->TCGGCAACGGT
TCGGCAACGGT->CGGCAACGGTA
CGGCAACGGTA->GGCAACGGTAG
GGCAACGGTAG->GCAACGGTAGG
GCAACGGTAGG->CAACGGTAGGA
CAACGGTAGGA->AACGGTAGGAG
AACGGTAGGAG->ACGGTAGGAGC
ACGGTAGGAGC->CGGTAGGAGCC
CGGTAGGAGCC->GGTAGGAGCCC
GGTAGGAGCCC->GTAGGAGCCCA
GTAGGAGCCCA->TAGGAGCCCAT
TAGGAGCCCAT->AGGAGCCCATC
AGGAGCCCATC->GGAGCCCATCC
GGAGCCCATCC->GAGCCCATCCA
GAGCCCATCCA->AGCCCATCCAG
AGCCCATCCAG->GCCCATCCAGC
GCCCATCCAGC->CCCATCCAGCA
CCCATCCAGCA->CCATCCAGCAG
CCATCCAGCAG->CATCCAGCAGC
CATCCAGCAGC->ATCCAGCAGCG
ATCCAGCAGCG->TCCAGCAGCGC
TCCAGCAGCGC->CCAGCAGCGCT
CCAGCAGCGCT->CAGCAGCGCTG
CAGCAGCGCTG->AGCAGCGCTGT
AGCAGCGCTGT->GCAGCGCTGTG
GCAGCGCTGTG->CAGCGCTGTGT
CAGCGCTGTGT->AGCGCTGTGTC
AGCGCTGTGTC->GCGCTGTGTCC
GCGCTGTGTCC->CGCTGTGTCCT
CGCTGTGTCCT->GCTGTGTCCTT
GCTGTGTCCTT->CTGTGTCCTTA
CTGTGTCCTTA->TGTGTCCTTAA
TGTGTCCTTAA->GTGTCCTTAAT
GTGTCCTTAAT->TGTCCTTAATG
TGTCCTTAATG->GTCCTTAATGC
GTCCTTAATGC->TCCTTAATGCC
TCCTTAATGCC->CCTTAATGCCT
CCTTAATGCCT->CTTAATGCCTG
CTTAATGCCTG->TTAATGCCTGC
TTAATGCCTGC->TAATGCCTGCC
TAATGCCTGCC->AATGCCTGCCA
AATGCCTGCCA->ATGCCTGCCAT
ATGCCTGCCAT->TGCCTGCCATC
TGCCTGCCATC->GCCTGCCATCT
GCCTGCCATCT->CCTGCCATCTC
CCTGCCATCTC->CTGCCATCTCG
CTGCCATCTCG->TGCCATCTCGA
TGCCATCTCGA->GCCATCTCGAA
GCCATCTCGAA->CCATCTCGAAT
CCATCTCGAAT->CATCTCGAATC
CATCTCGAATC->ATCTCGAATCT
ATCTCGAATCT->TCTCGAATCTG
TCTCGAATCTG->CTCGAATCTGT
CTCGAATCTGT->TCGAATCTGTG
TCGAATCTGTG->CGAATCTGTGT
CGAATCTGTGT->GAATCTGTGTT
GAATCTGTGTT->AATCTGTGTTT
AATCTGTGTTT->ATCTGTGTTTA
ATCTGTGTTTA->TCTGTGTTTAT
TCTGTGTTTAT->CTGTGTTTATC
CTGTGTTTATC->TGTGTTTATCG
TGTGTTTATCG->GTGTTTATCGA
GTGTTTATCGA->TGTTTATCGAC
TGTTTATCGAC->GTTTATCGACA
GTTTATCGACA->TTTATCGACAC
TTTATCGACAC->TTATCGACACT
TTATCGACACT->TATCGACACTG
TATCGACACTG->ATCGACACTGA
ATCGACACTGA->TCGACACTGAC
TCGACACTGAC->CGACACTGACT
CGACACTGACT->GACACTGACTA
GACACTGACTA->ACACTGACTAG
ACACTGACTAG->CACTGACTAGC
CACTGACTAGC->ACTGACTAGCT
ACTGACTAGCT->CTGACTAGCTG
CTGACTAGCTG->TGACTAGCTGA
TGACTAGCTGA->GACTAGCTGAA
GACTAGCTGAA->ACTAGCTGAAT
ACTAGCTGAAT->CTAGCTGAATT
CTAGCTGAATT->TAGCTGAATTG
TAGCTGAATTG->AGCTGAATTGC
AGCTGAATTGC->GCTGAATTGCG
GCTGAATTGCG->CTGAATTGCGT
CTGAATTGCGT->TGAATTGCGTA
TGAATTGCGTA->GAATTGCGTAG
GAATTGCGTAG->AATTGCGTAGT
AATTGCGTAGT->ATTGCGTAGTC
ATTGCGTAGTC->TTGCGTAGTCG
TTGCGTAGTCG->TGCGTAGTCGT
TGCGTAGTCGT->GCGTAGTCGTT
GCGTAGTCGTT->CGTAGTCGTTG
CGTAGTCGTTG->GTAGTCGTTGT
GTAGTCGTTGT->TAGTCGTTGTA
TAGTCGTTGTA->AGTCGTTGTAC
AGTCGTTGTAC->GTCGTTGTACG
GTCGTTGTACG->TCGTTGTACGG
TCGTTGTACGG->CGTTGTACGGT
CGTTGTACGGT->GTTGTACGGTA
GTTGTACGGTA->TTGTACGGTAC
TTGTACGGTAC->TGTACGGTACG
TGTACGGTACG->GTACGGTACGC
GTACGGTACGC->TACGGTACGCC
TACGGTACGCC->ACGGTACGCCC
ACGGTACGCCC->CGGTACGCCCT
CGGTACGCCCT->GGTACGCCCTC
GGTACGCCCTC->GTACGCCCTCA
GTACGCCCTCA->TACGCCCTCAA
TACGCCCTCAA->ACGCCCTCAAT
ACGCCCTCAAT->CGCCCTCAATT
CGCCCTCAATT->GCCCTCAATTC
GCCCTCAATTC->CCCTCAATTCC
CCCTCAATTCC->CCTCAATTCCA
CCTCAATTCCA->CTCAATTCCAA
CTCAATTCCAA->TCAATTCCAAA
TCAATTCCAAA->CAATTCCAAAC
CAATTCCAAAC->AATTCCAAACG
AATTCCAAACG->ATTCCAAACGA
ATTCCAAACGA->TTCCAAACGAC
TTCCAAACGAC->TCCAAACGACG
TCCAAACGACG->CCAAACGACGA
CCAAACGACGA->CAAACGACGAG
CAAACGACGAG->AAACGACGAGT
AAACGACGAGT->AACGACGAGTT
AACGACGAGTT->ACGACGAGTTA
ACGACGAGTTA->CGACGAGTTAT
CGACGAGTTAT->GACGAGTTATG
GACGAGTTATG->ACGAGTTATGC
ACGAGTTATGC->CGAGTTATGCA
CGAGTTATGCA->GAGTTATGCAA
GAGTTATGCAA->AGTTATGCAAC
AGTTATGCAAC->GTTATGCAACG
GTTATGCAACG->TTATGCAACGG
TTATGCAACGG->TATGCAACGGG
TATGCAACGGG->ATGCAACGGGC
ATGCAACGGGC->TGCAACGGGCG
TGCAACGGGCG->GCAACGGGCGT
GCAACGGGCGT->CAACGGGCGTT
CAACGGGCGTT->AACGGGCGTTA
AACGGGCGTTA->ACGGGCGTTAG
ACGGGCGTTAG->CGGGCGTTAGA
CGGGCGTTAGA->GGGCGTTAGAT
GGGCGTTAGAT->GGCGTTAGATG
GGCGTTAGATG->GCGTTAGATGG
GCGTTAGATGG->CGTTAGATGGT
CGTTAGATGGT->GTTAGATGGTC
GTTAGATGGTC->TTAGATGGTCG
TTAGATGGTCG->TAGATGGTCGT
TAGATGGTCGT->AGATGGTCGTG
AGATGGTCGTG->GATGGTCGTGA
GATGGTCGTGA->ATGGTCGTGAC
ATGGTCGTGAC->TGGTCGTGACG
TGGTCGTGACG->GGTCGTGACGG
GGTCGTGACGG->GTCGTGACGGA
GTCGTGACGGA->TCGTGACGGAA
TCGTGACGGAA->CGTGACGGAAG
CGTGACGGAAG->GTGACGGAAGG
GTGACGGAAGG->TGACGGAAGGA
TGACGGAAGGA->GACGGAAGGAA
GACGGAAGGAA->ACGGAAGGAAT
ACGGAAGGAAT->CGGAAGGAATC
CGGAAGGAATC->GGAAGGAATCG
GGAAGGAATCG->GAAGGAATCGT
GAAGGAATCGT->AAGGAATCGTC
AAGGAATCGTC->AGGAATCGTCT
AGGAATCGTCT->GGAATCGTCTG
GGAATCGTCTG->GAATCGTCTGG
GAATCGTCTGG->AATCGTCTGGG
AATCGTCTGGG->ATCGTCTGGGC
ATCGTCTGGGC->TCGTCTGGGCG
TCGTCTGGGCG->CGTCTGGGCGT
CGTCTGGGCGT->GTCTGGGCGTG
GTCTGGGCGTG->TCTGGGCGTGA
TCTGGGCGTGA->CTGGGCGTGAC
CTGGGCGTGAC->TGGGCGTGACA
TGGGCGTGACA->GGGCGTGACAG
GGGCGTGACAG->GGCGTGACAGC
GGCGTGACAGC->GCGTGACAGCC
GCGTGACAGCC->CGTGACAGCCC
CGTGACAGCCC->GTGACAGCCCT
GTGACAGCCCT->TGACAGCCCTA
TGACAGCCCTA->GACAGCCCTAT
GACAGCCCTAT->ACAGCCCTATG
ACAGCCCTATG->CAGCCCTATGC
CAGCCCTATGC->AGCCCTATGCT
AGCCCTATGCT->GCCCTATGCTA
GCCCTATGCTA->CCCTATGCTAG
CCCTATGCTAG->CCTATGCTAGA
CCTATGCTAGA->CTATGCTAGAG
CTATGCTAGAG->TATGCTAGAGC
TATGCTAGAGC->ATGCTAGAGCT
ATGCTAGAGCT->TGCTAGAGCTA
TGCTAGAGCTA->GCTAGAGCTAC
GCTAGAGCTAC->CTAGAGCTACG
CTAGAGCTACG->TAGAGCTACGT
TAGAGCTACGT->AGAGCTACGTA
AGAGCTACGTA->GAGCTACGTAG
GAGCTACGTAG->AGCTACGTAGA
AGCTACGTAGA->GCTACGTAGAC
GCTACGTAGAC->CTACGTAGACA
CTACGTAGACA->TACGTAGACAG
TACGTAGACAG->ACGTAGACAGA
ACGTAGACAGA->CGTAGACAGAG
CGTAGACAGAG->GTAGACAGAGA
GTAGACAGAGA->TAGACAGAGAA
TAGACAGAGAA->AGACAGAGAAG
AGACAGAGAAG->GACAGAGAAGC
GACAGAGAAGC->ACAGAGAAGCG
ACAGAGAAGCG->CAGAGAAGCGC
CAGAGAAGCGC->AGAGAAGCGCG
AGAGAAGCGCG->GAGAAGCGCGA
GAGAAGCGCGA->AGAAGCGCGAC
AGAAGCGCGAC->GAAGCGCGACG
GAAGCGCGACG->AAGCGCGACGC
AAGCGCGACGC->AGCGCGACGCG
AGCGCGACGCG->GCGCGACGCGT
GCGCGACGCGT->CGCGACGCGTT
CGCGACGCGTT->GCGACGCGTTG
GCGACGCGTTG->CGACGCGTTGT
CGACGCGTTGT->GACGCGTTGTT
GACGCGTTGTT->ACGCGTTGTTC
ACGCGTTGTTC->CGCGTTGTTCG
CGCGTTGTTCG->GCGTTGTTCGC
GCGTTGTTCGC->CGTTGTTCGCG
CGTTGTTCGCG->GTTGTTCGCGA
GTTGTTCGCGA->TTGTTCGCGAT
TTGTTCGCGAT->TGTTCGCGATT
TGTTCGCGATT->GTTCGCGATTC
GTTCGCGATTC->TTCGCGATTCC
TTCGCGATTCC->TCGCGATTCCT
TCGCGATTCCT->CGCGATTCCTA
CGCGATTCCTA->GCGATTCCTAT
GCGATTCCTAT->CGATTCCTATC
CGATTCCTATC->GATTCCTATCA
GATTCCTATCA->ATTCCTATCAT
ATTCCTATCAT->TTCCTATCATA
TTCCTATCATA->TCCTATCATAT
TCCTATCATAT->CCTATCATATC
CCTATCATATC->CTATCATATCA
CTATCATATCA->TATCATATCAC
TATCATATCAC->ATCATATCACG
ATCATATCACG->TCATATCACGG
TCATATCACGG->CATATCACGGA
CATATCACGGA->ATATCACGGAG
ATATCACGGAG->TATCACGGAGC
TATCACGGAGC->ATCACGGAGCA
ATCACGGAGCA->TCACGGAGCAT
TCACGGAGCAT->CACGGAGCATT
CACGGAGCATT->ACGGAGCATTA
ACGGAGCATTA->CGGAGCATTAG
CGGAGCATTAG->GGAGCATTAGG
GGAGCATTAGG->GAGCATTAGGA
GAGCATTAGGA->AGCATTAGGAT
AGCATTAGGAT->GCATTAGGATC
GCATTAGGATC->CATTAGGATCT
CATTAGGATCT->ATTAGGATCTT
ATTAGGATCTT->TTAGGATCTTG
TTAGGATCTTG->TAGGATCTTGG
TAGGATCTTGG->AGGATCTTGGT
AGGATCTTGGT->GGATCTTGGTG
GGATCTTGGTG->GATCTTGGTGT
GATCTTGGTGT->ATCTTGGTGTG
ATCTTGGTGTG->TCTTGGTGTGT
TCTTGGTGTGT->CTTGGTGTGTA
CTTGGTGTGTA->TTGGTGTGTAA
TTGGTGTGTAA->TGGTGTGTAAG
TGGTGTGTAAG->GGTGTGTAAGA
GGTGTGTAAGA->GTGTGTAAGAT
GTGTGTAAGAT->TGTGTAAGATT
TGTGTAAGATT->GTGTAAGATTG
GTGTAAGATTG->TGTAAGATTGC
TGTAAGATTGC->GTAAGATTGCT
GTAAGATTGCT->TAAGATTGCTG
TAAGATTGCTG->AAGATTGCTGA
AAGATTGCTGA->AGATTGCTGAC
AGATTGCTGAC->GATTGCTGACG
GATTGCTGACG->ATTGCTGACGC
ATTGCTGACGC->TTGCTGACGCA
TTGCTGACGCA->TGCTGACGCAG
TGCTGACGCAG->GCTGACGCAGT
GCTGACGCAGT->CTGACGCAGTC
CTGACGCAGTC->TGACGCAGTCA
TGACGCAGTCA->GACGCAGTCAG
GACGCAGTCAG->ACGCAGTCAGC
ACGCAGTCAGC->CGCAGTCAGCA
CGCAGTCAGCA->GCAGTCAGCAG
GCAGTCAGCAG->CAGTCAGCAGA
CAGTCAGCAGA->AGTCAGCAGAG
AGTCAGCAGAG->GTCAGCAGAGG
GTCAGCAGAGG->TCAGCAGAGGG
TCAGCAGAGGG->CAGCAGAGGGT
CAGCAGAGGGT->AGCAGAGGGTT
AGCAGAGGGTT->GCAGAGGGTTC
GCAGAGGGTTC->CAGAGGGTTCA
CAGAGGGTTCA->AGAGGGTTCAG
AGAGGGTTCAG->GAGGGTTCAGA
GAGGGTTCAGA->AGGGTTCAGAG
AGGGTTCAGAG->GGGTTCAGAGT
GGGTTCAGAGT->GGTTCAGAGTC
GGTTCAGAGTC->GTTCAGAGTCA
GTTCAGAGTCA->TTCAGAGTCAA
TTCAGAGTCAA->TCAGAGTCAAC
TCAGAGTCAAC->CAGAGTCAACG
CAGAGTCAACG->AGAGTCAACGT
AGAGTCAACGT->GAGTCAACGTA
GAGTCAACGTA->AGTCAACGTAG
AGTCAACGTAG->GTCAACGTAGA
GTCAACGTAGA->TCAACGTAGAG
TCAACGTAGAG->CAACGTAGAGT
CAACGTAGAGT->AACGTAGAGTG
AACGTAGAGTG->ACGTAGAGTGC
ACGTAGAGTGC->CGTAGAGTGCG
CGTAGAGTGCG->GTAGAGTGCGG
GTAGAGTGCGG->TAGAGTGCGGT
TAGAGTGCGGT->AGAGTGCGGTT
AGAGTGCGGTT->GAGTGCGGTTA
GAGTGCGGTTA->AGTGCGGTTAA
AGTGCGGTTAA->GTGCGGTTAAG
GTGCGGTTAAG->TGCGGTTAAGT
TGCGGTTAAGT->GCGGTTAAGTC
GCGGTTAAGTC->CGGTTAAGTCT
CGGTTAAGTCT->GGTTAAGTCTC
GGTTAAGTCTC->GTTAAGTCTCC
GTTAAGTCTCC->TTAAGTCTCCA
TTAAGTCTCCA->TAAGTCTCCAG
TAAGTCTCCAG->AAGTCTCCAGT
AAGTCTCCAGT->AGTCTCCAGTG
AGTCTCCAGTG->GTCTCCAGTGC
GTCTCCAGTGC->TCTCCAGTGCG
TCTCCAGTGCG->CTCCAGTGCGA
CTCCAGTGCGA->TCCAGTGCGAA
TCCAGTGCGAA->CCAGTGCGAAG
CCAGTGCGAAG->CAGTGCGAAGA
CAGTGCGAAGA->AGTGCGAAGAG
AGTGCGAAGAG->GTGCGAAGAGA
GTGCGAAGAGA->TGCGAAGAGAA
TGCGAAGAGAA->GCGAAGAGAAC
GCGAAGAGAAC->CGAAGAGAACC
CGAAGAGAACC->GAAGAGAACCC
GAAGAGAACCC->AAGAGAACCCG
AAGAGAACCCG->AGAGAACCCGA
AGAGAACCCGA->GAGAACCCGAC
GAGAACCCGAC->AGAACCCGACA
AGAACCCGACA->GAACCCGACAA
GAACCCGACAA->AACCCGACAAA
AACCCGACAAA->ACCCGACAAAG
ACCCGACAAAG->CCCGACAAAGG
CCCGACAAAGG->CCGACAAAGGA
CCGACAAAGGA->CGACAAAGGAA
CGACAAAGGAA->GACAAAGGAAC
GACAAAGGAAC->ACAAAGGAACC
ACAAAGGAACC->CAAAGGAACCT
CAAAGGAACCT->AAAGGAACCTT
AAAGGAACCTT->AAGGAACCTTG
AAGGAACCTTG->AGGAACCTTGG
AGGAACCTTGG->GGAACCTTGGT
GGAACCTTGGT->GAACCTTGGTG
GAACCTTGGTG->AACCTTGGTGA
AACCTTGGTGA->ACCTTGGTGAG
ACCTTGGTGAG->CCTTGGTGAGG
CCTTGGTGAGG->CTTGGTGAGGT
CTTGGTGAGGT->TTGGTGAGGTA
TTGGTGAGGTA->TGGTGAGGTAG
TGGTGAGGTAG->GGTGAGGTAGA
GGTGAGGTAGA->GTGAGGTAGAG
GTGAGGTAGAG->TGAGGTAGAGC
TGAGGTAGAGC->GAGGTAGAGCG
GAGGTAGAGCG->AGGTAGAGCGT
AGGTAGAGCGT->GGTAGAGCGTT
GGTAGAGCGTT->GTAGAGCGTTT
GTAGAGCGTTT->TAGAGCGTTTA
TAGAGCGTTTA->AGAGCGTTTAA
AGAGCGTTTAA->GAGCGTTTAAA
GAGCGTTTAAA->AGCGTTTAAAG
AGCGTTTAAAG->GCGTTTAAAGG
GCGTTTAAAGG->CGTTTAAAGGT
CGTTTAAAGGT->GTTTAAAGGTA
GTTTAAAGGTA->TTTAAAGGTAA
TTTAAAGGTAA->TTAAAGGTAAT
TTAAAGGTAAT->TAAAGGTAATG
TAAAGGTAATG->AAAGGTAATGG
AAAGGTAATGG->AAGGTAATGGG
AAGGTAATGGG->AGGTAATGGGT
AGGTAATGGGT->GGTAATGGGTA
GGTAATGGGTA->GTAATGGGTAG
GTAATGGGTAG->TAATGGGTAGC
TAATGGGTAGC->AATGGGTAGCT
AATGGGTAGCT->ATGGGTAGCTG
ATGGGTAGCTG->TGGGTAGCTGG
TGGGTAGCTGG->GGGTAGCTGGC
GGGTAGCTGGC->GGTAGCTGGCC
GGTAGCTGGCC->GTAGCTGGCCC
GTAGCTGGCCC->TAGCTGGCCCC
TAGCTGGCCCC->AGCTGGCCCCG
AGCTGGCCCCG->GCTGGCCCCGC
GCTGGCCCCGC->CTGGCCCCGCC
CTGGCCCCGCC->TGGCCCCGCCT
TGGCCCCGCCT->GGCCCCGCCTC
GGCCCCGCCTC->GCCCCGCCTCA
GCCCCGCCTCA->CCCCGCCTCAA
CCCCGCCTCAA->CCCGCCTCAAG
CCCGCCTCAAG->CCGCCTCAAGA
CGCCTCAAGAA->GCCTCAAGAAG
GCCTCAAGAAG->CCTCAAGAAGA
CCTCAAGAAGA->CTCAAGAAGAG
CTCAAGAAGAG->TCAAGAAGAGA
TCAAGAAGAGA->CAAGAAGAGAA
CAAGAAGAGAA->AAGAAGAGAAT
AAGAAGAGAAT->AGAAGAGAATC
AGAAGAGAATC->GAAGAGAATCG
GAAGAGAATCG->AAGAGAATCGC
AAGAGAATCGC->AGAGAATCGCG
AGAGAATCGCG->GAGAATCGCGA
GAGAATCGCGA->AGAATCGCGAA
AGAATCGCGAA->GAATCGCGAAC
GAATCGCGAAC->AATCGCGAACC
AATCGCGAACC->ATCGCGAACCC
ATCGCGAACCC->TCGCGAACCCC
TCGCGAACCCC->CGCGAACCCCA
CGCGAACCCCA->GCGAACCCCAG
GCGAACCCCAG->CGAACCCCAGT
CGAACCCCAGT->GAACCCCAGTA
GAACCCCAGTA->AACCCCAGTAA
AACCCCAGTAA->ACCCCAGTAAC
ACCCCAGTAAC->CCCCAGTAACA
CCCCAGTAACA->CCCAGTAACAC
CCCAGTAACAC->CCAGTAACACC
CCAGTAACACC->CAGTAACACCG
CAGTAACACCG->AGTAACACCGG
AGTAACACCGG->GTAACACCGGT
GTAACACCGGT->TAACACCGGTA
TAACACCGGTA->AACACCGGTAC
AACACCGGTAC->ACACCGGTACG
ACACCGGTACG->CACCGGTACGT
CACCGGTACGT->ACCGGTACGTA
ACCGGTACGTA->CCGGTACGTAG
CCGGTACGTAG->CGGTACGTAGG
CGGTACGTAGG->GGTACGTAGGT
GGTACGTAGGT->GTACGTAGGTA
GTACGTAGGTA->TACGTAGGTAA
TACGTAGGTAA->ACGTAGGTAAC
ACGTAGGTAAC->CGTAGGTAACG
CGTAGGTAACG->GTAGGTAACGC
GTAGGTAACGC->TAGGTAACGCA
TAGGTAACGCA->AGGTAACGCAA
AGGTAACGCAA->GGTAACGCAAT
GGTAACGCAAT->GTAACGCAATA
GTAACGCAATA->TAACGCAATAA
TAACGCAATAA->AACGCAATAAC
AACGCAATAAC->ACGCAATAACG
ACGCAATAACG->CGCAATAACGA
CGCAATAACGA->GCAATAACGAT
GCAATAACGAT->CAATAACGATC
CAATAACGATC->AATAACGATCT
AATAACGATCT->ATAACGATCTT
ATAACGATCTT->TAACGATCTTA
TAACGATCTTA->AACGATCTTAG
AACGATCTTAG->ACGATCTTAGT
ACGATCTTAGT->CGATCTTAGTC
CGATCTTAGTC->GATCTTAGTCT
GATCTTAGTCT->ATCTTAGTCTC
ATCTTAGTCTC->TCTTAGTCTCA
TCTTAGTCTCA->CTTAGTCTCAT
CTTAGTCTCAT->TTAGTCTCATG
TTAGTCTCATG->TAGTCTCATGG
TAGTCTCATGG->AGTCTCATGGT
AGTCTCATGGT->GTCTCATGGTT
GTCTCATGGTT->TCTCATGGTTC
TCTCATGGTTC->CTCATGGTTCA
CTCATGGTTCA->TCATGGTTCAT
TCATGGTTCAT->CATGGTTCATG
CATGGTTCATG->ATGGTTCATGC
ATGGTTCATGC->TGGTTCATGCC
TGGTTCATGCC->GGTTCATGCCT
GGTTCATGCCT->GTTCATGCCTT
GTTCATGCCTT->TTCATGCCTTC
TTCATGCCTTC->TCATGCCTTCG
TCATGCCTTCG->CATGCCTTCGT
CATGCCTTCGT->ATGCCTTCGTT
ATGCCTTCGTT->TGCCTTCGTTG
TGCCTTCGTTG->GCCTTCGTTGA
GCCTTCGTTGA->CCTTCGTTGAG
CCTTCGTTGAG->CTTCGTTGAGC
CTTCGTTGAGC->TTCGTTGAGCA
TTCGTTGAGCA->TCGTTGAGCAT
TCGTTGAGCAT->CGTTGAGCATG
CGTTGAGCATG->GTTGAGCATGT
GTTGAGCATGT->TTGAGCATGTG
TTGAGCATGTG->TGAGCATGTGT
TGAGCATGTGT->GAGCATGTGTT
GAGCATGTGTT->AGCATGTGTTC
AGCATGTGTTC->GCATGTGTTCC
GCATGTGTTCC->CATGTGTTCCG
CATGTGTTCCG->ATGTGTTCCGA
ATGTGTTCCGA->TGTGTTCCGAT
TGTGTTCCGAT->GTGTTCCGATG
GTGTTCCGATG->TGTTCCGATGA
TGTTCCGATGA->GTTCCGATGAA
GTTCCGATGAA->TTCCGATGAAT
TTCCGATGAAT->TCCGATGAATA
TCCGATGAATA->CCGATGAATAA
CCGATGAATAA->CGATGAATAAT
CGATGAATAAT->GATGAATAATA
GATGAATAATA->ATGAATAATAA
ATGAATAATAA->TGAATAATAAA
TGAATAATAAA->GAATAATAAAC
GAATAATAAAC->AATAATAAACG
AATAATAAACG->ATAATAAACGC
ATAATAAACGC->TAATAAACGCC
TAATAAACGCC->AATAAACGCCC
AATAAACGCCC->ATAAACGCCCA
ATAAACGCCCA->TAAACGCCCAC
TAAACGCCCAC->AAACGCCCACT
AAACGCCCACT->AACGCCCACTC
AACGCCCACTC->ACGCCCACTCG
ACGCCCACTCG->CGCCCACTCGT
CGCCCACTCGT->GCCCACTCGTG
GCCCACTCGTG->CCCACTCGTGC
CCCACTCGTGC->CCACTCGTGCC
CCACTCGTGCC->CACTCGTGCCC
CACTCGTGCCC->ACTCGTGCCCA
ACTCGTGCCCA->CTCGTGCCCAG
CTCGTGCCCAG->TCGTGCCCAGA
TCGTGCCCAGA->CGTGCCCAGAC
CGTGCCCAGAC->GTGCCCAGACC
GTGCCCAGACC->TGCCCAGACCG
TGCCCAGACCG->GCCCAGACCGA
GCCCAGACCGA->CCCAGACCGAC
CCCAGACCGAC->CCAGACCGACG
CCAGACCGACG->CAGACCGACGT
CAGACCGACGT->AGACCGACGTG
AGACCGACGTG->GACCGACGTGT
GACCGACGTGT->ACCGACGTGTG
ACCGACGTGTG->CCGACGTGTGG
CCGACGTGTGG->CGACGTGTGGG
CGACGTGTGGG->GACGTGTGGGA
GACGTGTGGGA->ACGTGTGGGAA
ACGTGTGGGAA->CGTGTGGGAAC
CGTGTGGGAAC->GTGTGGGAACT
GTGTGGGAACT->TGTGGGAACTA
TGTGGGAACTA->GTGGGAACTAT
GTGGGAACTAT->TGGGAACTATA
TGGGAACTATA->GGGAACTATAA
GGGAACTATAA->GGAACTATAAG
GGAACTATAAG->GAACTATAAGC
GAACTATAAGC->AACTATAAGCT
AACTATAAGCT->ACTATAAGCTG
ACTATAAGCTG->CTATAAGCTGA
CTATAAGCTGA->TATAAGCTGAA
TATAAGCTGAA->ATAAGCTGAAA
ATAAGCTGAAA->TAAGCTGAAAT
TAAGCTGAAAT->AAGCTGAAATG
AAGCTGAAATG->AGCTGAAATGA
AGCTGAAATGA->GCTGAAATGAC
GCTGAAATGAC->CTGAAATGACT
CTGAAATGACT->TGAAATGACTC
TGAAATGACTC->GAAATGACTCA
GAAATGACTCA->AAATGACTCAT
AAATGACTCAT->AATGACTCATT
AATGACTCATT->ATGACTCATTT
ATGACTCATTT->TGACTCATTTT
TGACTCATTTT->GACTCATTTTT
GACTCATTTTT->ACTCATTTTTA
ACTCATTTTTA->CTCATTTTTAG
CTCATTTTTAG->TCATTTTTAGT
TCATTTTTAGT->CATTTTTAGTG
CATTTTTAGTG->ATTTTTAGTGT
ATTTTTAGTGT->TTTTTAGTGTG
TTTTTAGTGTG->TTTTAGTGTGA
TTTTAGTGTGA->TTTAGTGTGAT
TTTAGTGTGAT->TTAGTGTGATC
TTAGTGTGATC->TAGTGTGATCA
TAGTGTGATCA->AGTGTGATCAA
AGTGTGATCAA->GTGTGATCAAG
GTGTGATCAAG->TGTGATCAAGC
TGTGATCAAGC->GTGATCAAGCG
GTGATCAAGCG->TGATCAAGCGC
TGATCAAGCGC->GATCAAGCGCA
GATCAAGCGCA->ATCAAGCGCAT
ATCAAGCGCAT->TCAAGCGCATT
TCAAGCGCATT->CAAGCGCATTG
CAAGCGCATTG->AAGCGCATTGG
AAGCGCATTGG->AGCGCATTGGG
AGCGCATTGGG->GCGCATTGGGA
GCGCATTGGGA->CGCATTGGGAC
CGCATTGGGAC->GCATTGGGACA
GCATTGGGACA->CATTGGGACAC
CATTGGGACAC->ATTGGGACACC
ATTGGGACACC->TTGGGACACCG
TTGGGACACCG->TGGGACACCGG
TGGGACACCGG->GGGACACCGGT
GGGACACCGGT->GGACACCGGTC
GGACACCGGTC->GACACCGGTCA
GACACCGGTCA->ACACCGGTCAG
ACACCGGTCAG->CACCGGTCAGC
CACCGGTCAGC->ACCGGTCAGCG
ACCGGTCAGCG->CCGGTCAGCGA
CCGGTCAGCGA->CGGTCAGCGAT
CGGTCAGCGAT->GGTCAGCGATT
GGTCAGCGATT->GTCAGCGATTC
GTCAGCGATTC->TCAGCGATTCC
TCAGCGATTCC->CAGCGATTCCG
CAGCGATTCCG->AGCGATTCCGC
AGCGATTCCGC->GCGATTCCGCA
GCGATTCCGCA->CGATTCCGCAG
CGATTCCGCAG->GATTCCGCAGG
GATTCCGCAGG->ATTCCGCAGGA
ATTCCGCAGGA->TTCCGCAGGAC
TTCCGCAGGAC->TCCGCAGGACT
TCCGCAGGACT->CCGCAGGACTA
CCGCAGGACTA->CGCAGGACTAT
CGCAGGACTAT->GCAGGACTATC
GCAGGACTATC->CAGGACTATCT
CAGGACTATCT->AGGACTATCTC
AGGACTATCTC->GGACTATCTCT
GGACTATCTCT->GACTATCTCTT
GACTATCTCTT->ACTATCTCTTC
ACTATCTCTTC->CTATCTCTTCA
CTATCTCTTCA->TATCTCTTCAA
TATCTCTTCAA->ATCTCTTCAAC
ATCTCTTCAAC->TCTCTTCAACC
TCTCTTCAACC->CTCTTCAACCC
CTCTTCAACCC->TCTTCAACCCC
TCTTCAACCCC->CTTCAACCCCG
CTTCAACCCCG->TTCAACCCCGG
TTCAACCCCGG->TCAACCCCGGA
TCAACCCCGGA->CAACCCCGGAT
CAACCCCGGAT->AACCCCGGATA
AACCCCGGATA->ACCCCGGATAC
ACCCCGGATAC->CCCCGGATACA
CCCCGGATACA->CCCGGATACAC
CCCGGATACAC->CCGGATACACG
CCGGATACACG->CGGATACACGG
CGGATACACGG->GGATACACGGT
GGATACACGGT->GATACACGGTG
GATACACGGTG->ATACACGGTGT
ATACACGGTGT->TACACGGTGTC
TACACGGTGTC->ACACGGTGTCA
ACACGGTGTCA->CACGGTGTCAG
CACGGTGTCAG->ACGGTGTCAGA
ACGGTGTCAGA->CGGTGTCAGAT
CGGTGTCAGAT->GGTGTCAGATT
GGTGTCAGATT->GTGTCAGATTT
GTGTCAGATTT->TGTCAGATTTT
TGTCAGATTTT->GTCAGATTTTT
GTCAGATTTTT->TCAGATTTTTA
TCAGATTTTTA->CAGATTTTTAG
CAGATTTTTAG->AGATTTTTAGC
AGATTTTTAGC->GATTTTTAGCC
GATTTTTAGCC->ATTTTTAGCCA
ATTTTTAGCCA->TTTTTAGCCAG
TTTTTAGCCAG->TTTTAGCCAGG
TTTTAGCCAGG->TTTAGCCAGGT
TTTAGCCAGGT->TTAGCCAGGTT
TTAGCCAGGTT->TAGCCAGGTTG
TAGCCAGGTTG->AGCCAGGTTGC
AGCCAGGTTGC->GCCAGGTTGCC
GCCAGGTTGCC->CCAGGTTGCCA
CCAGGTTGCCA->CAGGTTGCCAC
CAGGTTGCCAC->AGGTTGCCACT
AGGTTGCCACT->GGTTGCCACTA
GGTTGCCACTA->GTTGCCACTAC
GTTGCCACTAC->TTGCCACTACT
TTGCCACTACT->TGCCACTACTG
TGCCACTACTG->GCCACTACTGG
GCCACTACTGG->CCACTACTGGA
CCACTACTGGA->CACTACTGGAA
CACTACTGGAA->ACTACTGGAAG
ACTACTGGAAG->CTACTGGAAGT
CTACTGGAAGT->TACTGGAAGTT
TACTGGAAGTT->ACTGGAAGTTC
ACTGGAAGTTC->CTGGAAGTTCA
CTGGAAGTTCA->TGGAAGTTCAG
TGGAAGTTCAG->GGAAGTTCAGG
GGAAGTTCAGG->GAAGTTCAGGA
GAAGTTCAGGA->AAGTTCAGGAA
AAGTTCAGGAA->AGTTCAGGAAC
AGTTCAGGAAC->GTTCAGGAACT
GTTCAGGAACT->TTCAGGAACTA
TTCAGGAACTA->TCAGGAACTAA
TCAGGAACTAA->CAGGAACTAAA
CAGGAACTAAA->AGGAACTAAAC
AGGAACTAAAC->GGAACTAAACG
GGAACTAAACG->GAACTAAACGA
GAACTAAACGA->AACTAAACGAA
AACTAAACGAA->ACTAAACGAAG
ACTAAACGAAG->CTAAACGAAGA
CTAAACGAAGA->TAAACGAAGAG
TAAACGAAGAG->AAACGAAGAGT
AAACGAAGAGT->AACGAAGAGTT
AACGAAGAGTT->ACGAAGAGTTG
ACGAAGAGTTG->CGAAGAGTTGG
CGAAGAGTTGG->GAAGAGTTGGC
GAAGAGTTGGC->AAGAGTTGGCT
AAGAGTTGGCT->AGAGTTGGCTC
AGAGTTGGCTC->GAGTTGGCTCT
GAGTTGGCTCT->AGTTGGCTCTG
AGTTGGCTCTG->GTTGGCTCTGG
GTTGGCTCTGG->TTGGCTCTGGG
TTGGCTCTGGG->TGGCTCTGGGC
TGGCTCTGGGC->GGCTCTGGGCC
GGCTCTGGGCC->GCTCTGGGCCG
GCTCTGGGCCG->CTCTGGGCCGA
CTCTGGGCCGA->TCTGGGCCGAG
TCTGGGCCGAG->CTGGGCCGAGG
CTGGGCCGAGG->TGGGCCGAGGG
TGGGCCGAGGG->GGGCCGAGGGC
GGGCCGAGGGC->GGCCGAGGGCG
GGCCGAGGGCG->GCCGAGGGCGG
GCCGAGGGCGG->CCGAGGGCGGT
CCGAGGGCGGT->CGAGGGCGGTC
CGAGGGCGGTC->GAGGGCGGTCC
GAGGGCGGTCC->AGGGCGGTCCA
AGGGCGGTCCA->GGGCGGTCCAG
GGGCGGTCCAG->GGCGGTCCAGT
GGCGGTCCAGT->GCGGTCCAGTC
GCGGTCCAGTC->CGGTCCAGTCA
CGGTCCAGTCA->GGTCCAGTCAT
GGTCCAGTCAT->GTCCAGTCATT
GTCCAGTCATT->TCCAGTCATTC
TCCAGTCATTC->CCAGTCATTCT
CCAGTCATTCT->CAGTCATTCTC
CAGTCATTCTC->AGTCATTCTCG
AGTCATTCTCG->GTCATTCTCGG
GTCATTCTCGG->TCATTCTCGGC
TCATTCTCGGC->CATTCTCGGCA
CATTCTCGGCA->ATTCTCGGCAA
ATTCTCGGCAA->TTCTCGGCAAT
TTCTCGGCAAT->TCTCGGCAATC
TCTCGGCAATC->CTCGGCAATCC
CTCGGCAATCC->TCGGCAATCCT
TCGGCAATCCT->CGGCAATCCTG
CGGCAATCCTG->GGCAATCCTGG
GGCAATCCTGG->GCAATCCTGGC
GCAATCCTGGC->CAATCCTGGCC
CAATCCTGGCC->AATCCTGGCCA
AATCCTGGCCA->ATCCTGGCCAA
ATCCTGGCCAA->TCCTGGCCAAG
TCCTGGCCAAG->CCTGGCCAAGT
CCTGGCCAAGT->CTGGCCAAGTA
CTGGCCAAGTA->TGGCCAAGTAT
TGGCCAAGTAT->GGCCAAGTATG
GGCCAAGTATG->GCCAAGTATGA
GCCAAGTATGA->CCAAGTATGAG
CCAAGTATGAG->CAAGTATGAGG
CAAGTATGAGG->AAGTATGAGGC
AAGTATGAGGC->AGTATGAGGCG
AGTATGAGGCG->GTATGAGGCGC
GTATGAGGCGC->TATGAGGCGCC
TATGAGGCGCC->ATGAGGCGCCT
ATGAGGCGCCT->TGAGGCGCCTG
TGAGGCGCCTG->GAGGCGCCTGA
GAGGCGCCTGA->AGGCGCCTGAC
AGGCGCCTGAC->GGCGCCTGACT
GGCGCCTGACT->GCGCCTGACTT
GCGCCTGACTT->CGCCTGACTTG
CGCCTGACTTG->GCCTGACTTGC
GCCTGACTTGC->CCTGACTTGCC
CCTGACTTGCC->CTGACTTGCCT
CTGACTTGCCT->TGACTTGCCTT
TGACTTGCCTT->GACTTGCCTTT
GACTTGCCTTT->ACTTGCCTTTG
ACTTGCCTTTG->CTTGCCTTTGA
CTTGCCTTTGA->TTGCCTTTGAC
TTGCCTTTGAC->TGCCTTTGACG
TGCCTTTGACG->GCCTTTGACGA
GCCTTTGACGA->CCTTTGACGAC
CCTTTGACGAC->CTTTGACGACA
CTTTGACGACA->TTTGACGACAT
TTTGACGACAT->TTGACGACATA
TTGACGACATA->TGACGACATAG
TGACGACATAG->GACGACATAGT
GACGACATAGT->ACGACATAGTA
ACGACATAGTA->CGACATAGTAC
CGACATAGTAC->GACATAGTACC
GACATAGTACC->ACATAGTACCC
ACATAGTACCC->CATAGTACCCT
CATAGTACCCT->ATAGTACCCTA
ATAGTACCCTA->TAGTACCCTAA
TAGTACCCTAA->AGTACCCTAAC
AGTACCCTAAC->GTACCCTAACG
GTACCCTAACG->TACCCTAACGT
TACCCTAACGT->ACCCTAACGTC
ACCCTAACGTC->CCCTAACGTCC
CCCTAACGTCC->CCTAACGTCCG
CCTAACGTCCG->CTAACGTCCGC
CTAACGTCCGC->TAACGTCCGCC
TAACGTCCGCC->AACGTCCGCCA
AACGTCCGCCA->ACGTCCGCCAG
ACGTCCGCCAG->CGTCCGCCAGG
CGTCCGCCAGG->GTCCGCCAGGT
GTCCGCCAGGT->TCCGCCAGGTT
TCCGCCAGGTT->CCGCCAGGTTC
CCGCCAGGTTC->CGCCAGGTTCA
CGCCAGGTTCA->GCCAGGTTCAG
GCCAGGTTCAG->CCAGGTTCAGG
CCAGGTTCAGG->CAGGTTCAGGC
CAGGTTCAGGC->AGGTTCAGGCA
AGGTTCAGGCA->GGTTCAGGCAC
GGTTCAGGCAC->GTTCAGGCACG
GTTCAGGCACG->TTCAGGCACGT
TTCAGGCACGT->TCAGGCACGTT
TCAGGCACGTT->CAGGCACGTTT
CAGGCACGTTT->AGGCACGTTTA
AGGCACGTTTA->GGCACGTTTAG
GGCACGTTTAG->GCACGTTTAGG
GCACGTTTAGG->CACGTTTAGGC
CACGTTTAGGC->ACGTTTAGGCT
ACGTTTAGGCT->CGTTTAGGCTT
CGTTTAGGCTT->GTTTAGGCTTG
GTTTAGGCTTG->TTTAGGCTTGT
TTTAGGCTTGT->TTAGGCTTGTG
TTAGGCTTGTG->TAGGCTTGTGC
TAGGCTTGTGC->AGGCTTGTGCT
AGGCTTGTGCT->GGCTTGTGCTG
GGCTTGTGCTG->GCTTGTGCTGA
GCTTGTGCTGA->CTTGTGCTGAA
CTTGTGCTGAA->TTGTGCTGAAG
TTGTGCTGAAG->TGTGCTGAAGC
TGTGCTGAAGC->GTGCTGAAGCA
GTGCTGAAGCA->TGCTGAAGCAA
TGCTGAAGCAA->GCTGAAGCAAT
GCTGAAGCAAT->CTGAAGCAATA
CTGAAGCAATA->TGAAGCAATAT
TGAAGCAATAT->GAAGCAATATA
GAAGCAATATA->AAGCAATATAT
AAGCAATATAT->AGCAATATATC
AGCAATATATC->GCAATATATCT
GCAATATATCT->CAATATATCTA
CAATATATCTA->AATATATCTAA
AATATATCTAA->ATATATCTAAC
ATATATCTAAC->TATATCTAACT
TATATCTAACT->ATATCTAACTT
ATATCTAACTT->TATCTAACTTG
TATCTAACTTG->ATCTAACTTGT
ATCTAACTTGT->TCTAACTTGTG
TCTAACTTGTG->CTAACTTGTGG
CTAACTTGTGG->TAACTTGTGGC
TAACTTGTGGC->AACTTGTGGCA
AACTTGTGGCA->ACTTGTGGCAG
ACTTGTGGCAG->CTTGTGGCAGG
CTTGTGGCAGG->TTGTGGCAGGA
TTGTGGCAGGA->TGTGGCAGGAT
TGTGGCAGGAT->GTGGCAGGATA
GTGGCAGGATA->TGGCAGGATAT
TGGCAGGATAT->GGCAGGATATG
GGCAGGATATG->GCAGGATATGA
GCAGGATATGA->CAGGATATGAT
CAGGATATGAT->AGGATATGATC
AGGATATGATC->GGATATGATCT
GGATATGATCT->GATATGATCTG
GATATGATCTG->ATATGATCTGT
ATATGATCTGT->TATGATCTGTC
TATGATCTGTC->ATGATCTGTCG
ATGATCTGTCG->TGATCTGTCGT
TGATCTGTCGT->GATCTGTCGTC
GATCTGTCGTC->ATCTGTCGTCT
ATCTGTCGTCT->TCTGTCGTCTA
TCTGTCGTCTA->CTGTCGTCTAG
CTGTCGTCTAG->TGTCGTCTAGG
TGTCGTCTAGG->GTCGTCTAGGG
GTCGTCTAGGG->TCGTCTAGGGG
TCGTCTAGGGG->CGTCTAGGGGT
CGTCTAGGGGT->GTCTAGGGGTC
GTCTAGGGGTC->TCTAGGGGTCT
TCTAGGGGTCT->CTAGGGGTCTA
CTAGGGGTCTA->TAGGGGTCTAT
TAGGGGTCTAT->AGGGGTCTATG
AGGGGTCTATG->GGGGTCTATGT
GGGGTCTATGT->GGGTCTATGTG
GGGTCTATGTG->GGTCTATGTGG
GGTCTATGTGG->GTCTATGTGGG
GTCTATGTGGG->TCTATGTGGGT
TCTATGTGGGT->CTATGTGGGTC
CTATGTGGGTC->TATGTGGGTCA
TATGTGGGTCA->ATGTGGGTCAT
ATGTGGGTCAT->TGTGGGTCATA
TGTGGGTCATA->GTGGGTCATAG
GTGGGTCATAG->TGGGTCATAGA
TGGGTCATAGA->GGGTCATAGAA
GGGTCATAGAA->GGTCATAGAAA
GGTCATAGAAA->GTCATAGAAAG
GTCATAGAAAG->TCATAGAAAGA
TCATAGAAAGA->CATAGAAAGAA
CATAGAAAGAA->ATAGAAAGAAC
ATAGAAAGAAC->TAGAAAGAACG
TAGAAAGAACG->AGAAAGAACGA
AGAAAGAACGA->GAAAGAACGAA
GAAAGAACGAA->AAAGAACGAAC
AAAGAACGAAC->AAGAACGAACA
AAGAACGAACA->AGAACGAACAC
AGAACGAACAC->GAACGAACACT
GAACGAACACT->AACGAACACTA
AACGAACACTA->ACGAACACTAA
ACGAACACTAA->CGAACACTAAT
CGAACACTAAT->GAACACTAATG
GAACACTAATG->AACACTAATGA
AACACTAATGA->ACACTAATGAC
ACACTAATGAC->CACTAATGACA
CACTAATGACA->ACTAATGACAA
ACTAATGACAA->CTAATGACAAA
CTAATGACAAA->TAATGACAAAT
TAATGACAAAT->AATGACAAATC
AATGACAAATC->ATGACAAATCC
ATGACAAATCC->TGACAAATCCA
TGACAAATCCA->GACAAATCCAG
GACAAATCCAG->ACAAATCCAGC
ACAAATCCAGC->CAAATCCAGCT
CAAATCCAGCT->AAATCCAGCTA
AAATCCAGCTA->AATCCAGCTAT
AATCCAGCTAT->ATCCAGCTATT
ATCCAGCTATT->TCCAGCTATTT
TCCAGCTATTT->CCAGCTATTTT
CCAGCTATTTT->CAGCTATTTTG
CAGCTATTTTG->AGCTATTTTGC
AGCTATTTTGC->GCTATTTTGCG
GCTATTTTGCG->CTATTTTGCGA
CTATTTTGCGA->TATTTTGCGAC
TATTTTGCGAC->ATTTTGCGACC
ATTTTGCGACC->TTTTGCGACCT
TTTTGCGACCT->TTTGCGACCTC
TTTGCGACCTC->TTGCGACCTCC
TTGCGACCTCC->TGCGACCTCCG
TGCGACCTCCG->GCGACCTCCGT
GCGACCTCCGT->CGACCTCCGTC
CGACCTCCGTC->GACCTCCGTCA
GACCTCCGTCA->ACCTCCGTCAG
ACCTCCGTCAG->CCTCCGTCAGC
CCTCCGTCAGC->CTCCGTCAGCC
CTCCGTCAGCC->TCCGTCAGCCA
TCCGTCAGCCA->CCGTCAGCCAG
CCGTCAGCCAG->CGTCAGCCAGC
CGTCAGCCAGC->GTCAGCCAGCC
GTCAGCCAGCC->TCAGCCAGCCC
TCAGCCAGCCC->CAGCCAGCCCG
CAGCCAGCCCG->AGCCAGCCCGG
AGCCAGCCCGG->GCCAGCCCGGC
GCCAGCCCGGC->CCAGCCCGGCG
CCAGCCCGGCG->CAGCCCGGCGT
CAGCCCGGCGT->AGCCCGGCGTA
AGCCCGGCGTA->GCCCGGCGTAT
GCCCGGCGTAT->CCCGGCGTATG
CCCGGCGTATG->CCGGCGTATGT
CCGGCGTATGT->CGGCGTATGTT
CGGCGTATGTT->GGCGTATGTTG
GGCGTATGTTG->GCGTATGTTGG
GCGTATGTTGG->CGTATGTTGGA
CGTATGTTGGA->GTATGTTGGAA
GTATGTTGGAA->TATGTTGGAAT
TATGTTGGAAT->ATGTTGGAATT
ATGTTGGAATT->TGTTGGAATTC
TGTTGGAATTC->GTTGGAATTCC
GTTGGAATTCC->TTGGAATTCCA
TTGGAATTCCA->TGGAATTCCAC
TGGAATTCCAC->GGAATTCCACA
GGAATTCCACA->GAATTCCACAC
GAATTCCACAC->AATTCCACACG
AATTCCACACG->ATTCCACACGT
ATTCCACACGT->TTCCACACGTT
TTCCACACGTT->TCCACACGTTG
TCCACACGTTG->CCACACGTTGC
CCACACGTTGC->CACACGTTGCT
CACACGTTGCT->ACACGTTGCTA
ACACGTTGCTA->CACGTTGCTAA
CACGTTGCTAA->ACGTTGCTAAC
ACGTTGCTAAC->CGTTGCTAACA
CGTTGCTAACA->GTTGCTAACAC
GTTGCTAACAC->TTGCTAACACA
TTGCTAACACA->TGCTAACACAG
TGCTAACACAG->GCTAACACAGC
GCTAACACAGC->CTAACACAGCA
CTAACACAGCA->TAACACAGCAT
TAACACAGCAT->AACACAGCATA
AACACAGCATA->ACACAGCATAC
ACACAGCATAC->CACAGCATACA
CACAGCATACA->ACAGCATACAC
ACAGCATACAC->CAGCATACACT
CAGCATACACT->AGCATACACTC
AGCATACACTC->GCATACACTCG
GCATACACTCG->CATACACTCGG
CATACACTCGG->ATACACTCGGC
ATACACTCGGC->TACACTCGGCC
TACACTCGGCC->ACACTCGGCCT
ACACTCGGCCT->CACTCGGCCTA
CACTCGGCCTA->ACTCGGCCTAG
ACTCGGCCTAG->CTCGGCCTAGC
CTCGGCCTAGC->TCGGCCTAGCC
TCGGCCTAGCC->CGGCCTAGCCG
CGGCCTAGCCG->GGCCTAGCCGA
GGCCTAGCCGA->GCCTAGCCGAT
GCCTAGCCGAT->CCTAGCCGATG
CCTAGCCGATG->CTAGCCGATGC
CTAGCCGATGC->TAGCCGATGCT
TAGCCGATGCT->AGCCGATGCTT
AGCCGATGCTT->GCCGATGCTTG
GCCGATGCTTG->CCGATGCTTGT
CCGATGCTTGT->CGATGCTTGTG
CGATGCTTGTG->GATGCTTGTGG
GATGCTTGTGG->ATGCTTGTGGT
ATGCTTGTGGT->TGCTTGTGGTT
TGCTTGTGGTT->GCTTGTGGTTT
GCTTGTGGTTT->CTTGTGGTTTG
CTTGTGGTTTG->TTGTGGTTTGC
TTGTGGTTTGC->TGTGGTTTGCA
TGTGGTTTGCA->GTGGTTTGCAT
GTGGTTTGCAT->TGGTTTGCATT
TGGTTTGCATT->GGTTTGCATTA
GGTTTGCATTA->GTTTGCATTAG
GTTTGCATTAG->TTTGCATTAGG
TTTGCATTAGG->TTGCATTAGGC
TTGCATTAGGC->TGCATTAGGCG
TGCATTAGGCG->GCATTAGGCGA
GCATTAGGCGA->CATTAGGCGAC
CATTAGGCGAC->ATTAGGCGACA
ATTAGGCGACA->TTAGGCGACAA
TTAGGCGACAA->TAGGCGACAAA
TAGGCGACAAA->AGGCGACAAAG
AGGCGACAAAG->GGCGACAAAGA
GGCGACAAAGA->GCGACAAAGAT
GCGACAAAGAT->CGACAAAGATA
CGACAAAGATA->GACAAAGATAG
GACAAAGATAG->ACAAAGATAGC
ACAAAGATAGC->CAAAGATAGCG
CAAAGATAGCG->AAAGATAGCGT
AAAGATAGCGT->AAGATAGCGTC
AAGATAGCGTC->AGATAGCGTCC
AGATAGCGTCC->GATAGCGTCCT
GATAGCGTCCT->ATAGCGTCCTG
ATAGCGTCCTG->TAGCGTCCTGT
TAGCGTCCTGT->AGCGTCCTGTA
AGCGTCCTGTA->GCGTCCTGTAC
GCGTCCTGTAC->CGTCCTGTACC
CGTCCTGTACC->GTCCTGTACCT
GTCCTGTACCT->TCCTGTACCTA
TCCTGTACCTA->CCTGTACCTAA
CCTGTACCTAA->CTGTACCTAAC
CTGTACCTAAC->TGTACCTAACT
TGTACCTAACT->GTACCTAACTG
GTACCTAACTG->TACCTAACTGA
TACCTAACTGA->ACCTAACTGAT
ACCTAACTGAT->CCTAACTGATC
CCTAACTGATC->CTAACTGATCT
CTAACTGATCT->TAACTGATCTT
TAACTGATCTT->AACTGATCTTG
AACTGATCTTG->ACTGATCTTGC
ACTGATCTTGC->CTGATCTTGCG
CTGATCTTGCG->TGATCTTGCGC
TGATCTTGCGC->GATCTTGCGCT
GATCTTGCGCT->ATCTTGCGCTT
ATCTTGCGCTT->TCTTGCGCTTG
TCTTGCGCTTG->CTTGCGCTTGC
CTTGCGCTTGC->TTGCGCTTGCC
TTGCGCTTGCC->TGCGCTTGCCC
TGCGCTTGCCC->GCGCTTGCCCT
GCGCTTGCCCT->CGCTTGCCCTA
CGCTTGCCCTA->GCTTGCCCTAA
GCTTGCCCTAA->CTTGCCCTAAA
CTTGCCCTAAA->TTGCCCTAAAC
TTGCCCTAAAC->TGCCCTAAACA
TGCCCTAAACA->GCCCTAAACAG
GCCCTAAACAG->CCCTAAACAGC
CCCTAAACAGC->CCTAAACAGCG
CCTAAACAGCG->CTAAACAGCGC
CTAAACAGCGC->TAAACAGCGCC
TAAACAGCGCC->AAACAGCGCCG
AAACAGCGCCG->AACAGCGCCGG
AACAGCGCCGG->ACAGCGCCGGT
ACAGCGCCGGT->CAGCGCCGGTC
CAGCGCCGGTC->AGCGCCGGTCC
AGCGCCGGTCC->GCGCCGGTCCA
GCGCCGGTCCA->CGCCGGTCCAT
CGCCGGTCCAT->GCCGGTCCATA
GCCGGTCCATA->CCGGTCCATAA
CCGGTCCATAA->CGGTCCATAAA
CGGTCCATAAA->GGTCCATAAAT
GGTCCATAAAT->GTCCATAAATC
GTCCATAAATC->TCCATAAATCC
TCCATAAATCC->CCATAAATCCT
CCATAAATCCT->CATAAATCCTG
CATAAATCCTG->ATAAATCCTGT
ATAAATCCTGT->TAAATCCTGTA
TAAATCCTGTA->AAATCCTGTAC
AAATCCTGTAC->AATCCTGTACT
AATCCTGTACT->ATCCTGTACTT
ATCCTGTACTT->TCCTGTACTTT
TCCTGTACTTT->CCTGTACTTTA
CCTGTACTTTA->CTGTACTTTAT
CTGTACTTTAT->TGTACTTTATC
TGTACTTTATC->GTACTTTATCT
GTACTTTATCT->TACTTTATCTC
TACTTTATCTC->ACTTTATCTCT
ACTTTATCTCT->CTTTATCTCTG
CTTTATCTCTG->TTTATCTCTGT
TTTATCTCTGT->TTATCTCTGTC
TTATCTCTGTC->TATCTCTGTCT
TATCTCTGTCT->ATCTCTGTCTT
ATCTCTGTCTT->TCTCTGTCTTC
TCTCTGTCTTC->CTCTGTCTTCT
CTCTGTCTTCT->TCTGTCTTCTC
TCTGTCTTCTC->CTGTCTTCTCA
CTGTCTTCTCA->TGTCTTCTCAT
TGTCTTCTCAT->GTCTTCTCATA
GTCTTCTCATA->TCTTCTCATAA
TCTTCTCATAA->CTTCTCATAAC
CTTCTCATAAC->TTCTCATAACA
TTCTCATAACA->TCTCATAACAG
TCTCATAACAG->CTCATAACAGA
CTCATAACAGA->TCATAACAGAG
TCATAACAGAG->CATAACAGAGT
CATAACAGAGT->ATAACAGAGTC
ATAACAGAGTC->TAACAGAGTCT
TAACAGAGTCT->AACAGAGTCTG
AACAGAGTCTG->ACAGAGTCTGG
ACAGAGTCTGG->CAGAGTCTGGT
CAGAGTCTGGT->AGAGTCTGGTC
AGAGTCTGGTC->GAGTCTGGTCG
GAGTCTGGTCG->AGTCTGGTCGA
AGTCTGGTCGA->GTCTGGTCGAG
GTCTGGTCGAG->TCTGGTCGAGC
TCTGGTCGAGC->CTGGTCGAGCA
CTGGTCGAGCA->TGGTCGAGCAT
TGGTCGAGCAT->GGTCGAGCATG
GGTCGAGCATG->GTCGAGCATGG
GTCGAGCATGG->TCGAGCATGGT
TCGAGCATGGT->CGAGCATGGTC
CGAGCATGGTC->GAGCATGGTCA
GAGCATGGTCA->AGCATGGTCAG
AGCATGGTCAG->GCATGGTCAGC
GCATGGTCAGC->CATGGTCAGCA
CATGGTCAGCA->ATGGTCAGCAC
ATGGTCAGCAC->TGGTCAGCACA
TGGTCAGCACA->GGTCAGCACAA
GGTCAGCACAA->GTCAGCACAAA
GTCAGCACAAA->TCAGCACAAAA
TCAGCACAAAA->CAGCACAAAAT
CAGCACAAAAT->AGCACAAAATC
AGCACAAAATC->GCACAAAATCT
GCACAAAATCT->CACAAAATCTA
CACAAAATCTA->ACAAAATCTAA
ACAAAATCTAA->CAAAATCTAAT
CAAAATCTAAT->AAAATCTAATA
AAAATCTAATA->AAATCTAATAC
AAATCTAATAC->AATCTAATACC
AATCTAATACC->ATCTAATACCG
ATCTAATACCG->TCTAATACCGA
TCTAATACCGA->CTAATACCGAG
CTAATACCGAG->TAATACCGAGG
TAATACCGAGG->AATACCGAGGG
AATACCGAGGG->ATACCGAGGGA
ATACCGAGGGA->TACCGAGGGAG
TACCGAGGGAG->ACCGAGGGAGA
ACCGAGGGAGA->CCGAGGGAGAC
CCGAGGGAGAC->CGAGGGAGACG
CGAGGGAGACG->GAGGGAGACGA
GAGGGAGACGA->AGGGAGACGAA
AGGGAGACGAA->GGGAGACGAAT
GGGAGACGAAT->GGAGACGAATT
GGAGACGAATT->GAGACGAATTG
GAGACGAATTG->AGACGAATTGC
AGACGAATTGC->GACGAATTGCC
GACGAATTGCC->ACGAATTGCCT
ACGAATTGCCT->CGAATTGCCTA
CGAATTGCCTA->GAATTGCCTAG
GAATTGCCTAG->AATTGCCTAGT
AATTGCCTAGT->ATTGCCTAGTT
ATTGCCTAGTT->TTGCCTAGTTC
TTGCCTAGTTC->TGCCTAGTTCC
TGCCTAGTTCC->GCCTAGTTCCT
GCCTAGTTCCT->CCTAGTTCCTT
CCTAGTTCCTT->CTAGTTCCTTT
CTAGTTCCTTT->TAGTTCCTTTG
TAGTTCCTTTG->AGTTCCTTTGC
AGTTCCTTTGC->GTTCCTTTGCG
GTTCCTTTGCG->TTCCTTTGCGG
TTCCTTTGCGG->TCCTTTGCGGG
TCCTTTGCGGG->CCTTTGCGGGG
CCTTTGCGGGG->CTTTGCGGGGG
CTTTGCGGGGG->TTTGCGGGGGG
TTTGCGGGGGG->TTGCGGGGGGA
TTGCGGGGGGA->TGCGGGGGGAT
TGCGGGGGGAT->GCGGGGGGATA
GCGGGGGGATA->CGGGGGGATAA
CGGGGGGATAA->GGGGGGATAAT
GGGGGGATAAT->GGGGGATAATG
GGGGGATAATG->GGGGATAATGG
GGGGATAATGG->GGGATAATGGA
GGGATAATGGA->GGATAATGGAT
GGATAATGGAT->GATAATGGATC
GATAATGGATC->ATAATGGATCG
ATAATGGATCG->TAATGGATCGC
TAATGGATCGC->AATGGATCGCC
AATGGATCGCC->ATGGATCGCCT
ATGGATCGCCT->TGGATCGCCTG
TGGATCGCCTG->GGATCGCCTGT
GGATCGCCTGT->GATCGCCTGTG
GATCGCCTGTG->ATCGCCTGTGT
ATCGCCTGTGT->TCGCCTGTGTT
TCGCCTGTGTT->CGCCTGTGTTA
CGCCTGTGTTA->GCCTGTGTTAG
GCCTGTGTTAG->CCTGTGTTAGC
CCTGTGTTAGC->CTGTGTTAGCA
CTGTGTTAGCA->TGTGTTAGCAT
TGTGTTAGCAT->GTGTTAGCATT
GTGTTAGCATT->TGTTAGCATTT
TGTTAGCATTT->GTTAGCATTTA
GTTAGCATTTA->TTAGCATTTAG
TTAGCATTTAG->TAGCATTTAGT
TAGCATTTAGT->AGCATTTAGTA
AGCATTTAGTA->GCATTTAGTAA
GCATTTAGTAA->CATTTAGTAAT
CATTTAGTAAT->ATTTAGTAATC
ATTTAGTAATC->TTTAGTAATCG
TTTAGTAATCG->TTAGTAATCGC
TTAGTAATCGC->TAGTAATCGCA
TAGTAATCGCA->AGTAATCGCAC
AGTAATCGCAC->GTAATCGCACT
GTAATCGCACT->TAATCGCACTG
TAATCGCACTG->AATCGCACTGA
AATCGCACTGA->ATCGCACTGAT
ATCGCACTGAT->TCGCACTGATA
TCGCACTGATA->CGCACTGATAT
CGCACTGATAT->GCACTGATATG
GCACTGATATG->CACTGATATGA
CACTGATATGA->ACTGATATGAA
ACTGATATGAA->CTGATATGAAG
CTGATATGAAG->TGATATGAAGG
TGATATGAAGG->GATATGAAGGT
GATATGAAGGT->ATATGAAGGTC
ATATGAAGGTC->TATGAAGGTCT
TATGAAGGTCT->ATGAAGGTCTC
ATGAAGGTCTC->TGAAGGTCTCG
TGAAGGTCTCG->GAAGGTCTCGC
GAAGGTCTCGC->AAGGTCTCGCT
AAGGTCTCGCT->AGGTCTCGCTG
AGGTCTCGCTG->GGTCTCGCTGG
GGTCTCGCTGG->GTCTCGCTGGA
GTCTCGCTGGA->TCTCGCTGGAG
TCTCGCTGGAG->CTCGCTGGAGG
CTCGCTGGAGG->TCGCTGGAGGG
TCGCTGGAGGG->CGCTGGAGGGA
CGCTGGAGGGA->GCTGGAGGGAC
GCTGGAGGGAC->CTGGAGGGACG
CTGGAGGGACG->TGGAGGGACGT
TGGAGGGACGT->GGAGGGACGTT
GGAGGGACGTT->GAGGGACGTTT
GAGGGACGTTT->AGGGACGTTTC
AGGGACGTTTC->GGGACGTTTCT
GGGACGTTTCT->GGACGTTTCTA
GGACGTTTCTA->GACGTTTCTAG
GACGTTTCTAG->ACGTTTCTAGT
ACGTTTCTAGT->CGTTTCTAGTG
CGTTTCTAGTG->GTTTCTAGTGA
GTTTCTAGTGA->TTTCTAGTGAT
TTTCTAGTGAT->TTCTAGTGATT
TTCTAGTGATT->TCTAGTGATTC
TCTAGTGATTC->CTAGTGATTCT
CTAGTGATTCT->TAGTGATTCTA
TAGTGATTCTA->AGTGATTCTAC
AGTGATTCTAC->GTGATTCTACC
GTGATTCTACC->TGATTCTACCC
TGATTCTACCC->GATTCTACCCC
GATTCTACCCC->ATTCTACCCCA
ATTCTACCCCA->TTCTACCCCAC
TTCTACCCCAC->TCTACCCCACA
TCTACCCCACA->CTACCCCACAG
CTACCCCACAG->TACCCCACAGA
TACCCCACAGA->ACCCCACAGAG
ACCCCACAGAG->CCCCACAGAGT
CCCCACAGAGT->CCCACAGAGTC
CCCACAGAGTC->CCACAGAGTCA
CCACAGAGTCA->CACAGAGTCAA
CACAGAGTCAA->ACAGAGTCAAG
ACAGAGTCAAG->CAGAGTCAAGC
CAGAGTCAAGC->AGAGTCAAGCC
AGAGTCAAGCC->GAGTCAAGCCG
GAGTCAAGCCG->AGTCAAGCCGC
AGTCAAGCCGC->GTCAAGCCGCC
GTCAAGCCGCC->TCAAGCCGCCC
TCAAGCCGCCC->CAAGCCGCCCT
CAAGCCGCCCT->AAGCCGCCCTC
AAGCCGCCCTC->AGCCGCCCTCG
AGCCGCCCTCG->GCCGCCCTCGT
GCCGCCCTCGT->CCGCCCTCGTC
CCGCCCTCGTC->CGCCCTCGTCT
CGCCCTCGTCT->GCCCTCGTCTT
