TAAGATGGAAGACTGGGTA -> AAGATGGAAGACTGGGTAC
GCATGAGATATAAGCAGCG -> CATGAGATATAAGCAGCGA
GAAGGAGTATATAACATGT -> AAGGAGTATATAACATGTA
GTACCGTAACGAATCCCAA -> TACCGTAACGAATCCCAAG
GCCTGATTATAGCACGGAT -> CCTGATTATAGCACGGATC
TGGTATCTGCCCGCAAAAG -> GGTATCTGCCCGCAAAAGC
TTCCGGTCGGCCCTTCAGC -> TCCGGTCGGCCCTTCAGCT
ACCCCTGATATTGTACCTA -> CCCCTGATATTGTACCTAT
GAGACTAAACGCGAACGAC -> AGACTAAACGCGAACGACA
GTTGGGATACAGGGTGTGG -> TTGGGATACAGGGTGTGGG
AGTCATCATGTAAGATGGA -> GTCATCATGTAAGATGGAA
TTTTTCTATAATGATTGCC -> TTTTCTATAATGATTGCCG
GCGTACTGATCACCCGTCG -> CGTACTGATCACCCGTCGC
GTTTTTCTATAATGATTGC -> TTTTTCTATAATGATTGCC
GTCGGCCCTTCAGCTCTCT -> TCGGCCCTTCAGCTCTCTT
CTAGTCAAGAATCATAAAG -> TAGTCAAGAATCATAAAGT
GCAAATGCAGGAATCTGCC -> CAAATGCAGGAATCTGCCA
TCTCATGTCGATATTTCCG -> CTCATGTCGATATTTCCGG
GTGGCCATCTCATGTCGAT -> TGGCCATCTCATGTCGATA
AGAACAGTCTGATCGGGTT -> GAACAGTCTGATCGGGTTA
ACTCTGGAAATCCGTGAGC -> CTCTGGAAATCCGTGAGCA
ATAACGAGGGTTCCTGTTG -> TAACGAGGGTTCCTGTTGC
ATAGCACGGATCGACGCAT -> TAGCACGGATCGACGCATG
GAGGGCTCAGGCGTTACTT -> AGGGCTCAGGCGTTACTTA
CTCGACAGATCACTCCGGA -> TCGACAGATCACTCCGGAC
CCGTATTATGTACCGTAAC -> CGTATTATGTACCGTAACG
ACCCGTCGCAATTTACGGT -> CCCGTCGCAATTTACGGTA
GCTGTAGGACCGTATTATG -> CTGTAGGACCGTATTATGT
TAGGAAGGTCTATAGCATC -> AGGAAGGTCTATAGCATCA
TAAATTGGGAACACCTTTT -> AAATTGGGAACACCTTTTT
AAGCCCTCATGAACAGCTA -> AGCCCTCATGAACAGCTAC
TCTATAATGATTGCCGCAA -> CTATAATGATTGCCGCAAA
ACGTAGCGTTCTAATCAAT -> CGTAGCGTTCTAATCAATC
AAGAATCATAAAGTCGCGC -> AGAATCATAAAGTCGCGCC
AGCGAGACTAGTCAAGAAT -> GCGAGACTAGTCAAGAATC
TGTGTGAAGCGTGTGATGG -> GTGTGAAGCGTGTGATGGT
GGTGGATGCTGTTTTAGAG -> GTGGATGCTGTTTTAGAGC
CGCAGAGATAACCACGTCC -> GCAGAGATAACCACGTCCC
AAGACCGGGTGTGTATGGT -> AGACCGGGTGTGTATGGTT
GCCCCTTCGCTTAGGTTGG -> CCCCTTCGCTTAGGTTGGA
GACCCTATATGGTCACCAC -> ACCCTATATGGTCACCACG
ACGATAATTCGGGTAAATC -> CGATAATTCGGGTAAATCA
ATCGACATGCACGCATACA -> TCGACATGCACGCATACAG
CCTGTTGCTTAAGAACAGT -> CTGTTGCTTAAGAACAGTC
CATACTCCGTTACCCGAGT -> ATACTCCGTTACCCGAGTA
CTCTGGAAATCCGTGAGCA -> TCTGGAAATCCGTGAGCAA
ACCTTAAGCGGGGTTTGAG -> CCTTAAGCGGGGTTTGAGT
CCGTTCACTGGAGGTTATG -> CGTTCACTGGAGGTTATGT
ATGAACAGCTACCTATCCC -> TGAACAGCTACCTATCCCT
TCCAAAAGGCTCGTCCCGC -> CCAAAAGGCTCGTCCCGCT
GTCGGCGTCAGCTCTATAG -> TCGGCGTCAGCTCTATAGA
CTATAGGAAGGTCTATAGC -> TATAGGAAGGTCTATAGCA
GTAAGATGGAAGACTGGGT -> TAAGATGGAAGACTGGGTA
CCATTGAGCTCCATGAGCA -> CATTGAGCTCCATGAGCAA
GAACTCATTAACAATGATG -> AACTCATTAACAATGATGA
TCCGGACACCCTTAACTTA -> CCGGACACCCTTAACTTAT
TAAATCGGGGAACACGGTT -> AAATCGGGGAACACGGTTA
CAAGAATCATAAAGTCGCC -> AAGAATCATAAAGTCGCCC
TAATTCGGGTAAATCATGC -> AATTCGGGTAAATCATGCG
CAGCTCTCTTAAATCGGGG -> AGCTCTCTTAAATCGGGGA
TTCTTAAGGTCGGGTAACG -> TCTTAAGGTCGGGTAACGT
CAGGTGGAACTCATTAACA -> AGGTGGAACTCATTAACAA
CCTCAGCCCCGAGCCATTC -> CTCAGCCCCGAGCCATTCT
TTGCAGTATCAGACTCTGT -> TGCAGTATCAGACTCTGTA
CAATCCGAATTATGATAGT -> AATCCGAATTATGATAGTC
CGGGTAAATCATGCGGGTT -> GGGTAAATCATGCGGGTTC
ATTAACAATGATGAGTGTT -> TTAACAATGATGAGTGTTG
TGCGCGGTAGTGACGAAGG -> GCGCGGTAGTGACGAAGGA
CCAACTTCTGATGAGAAAA -> CAACTTCTGATGAGAAAAA
GCAACCAACTTCTGATGAG -> CAACCAACTTCTGATGAGA
TATTGTACCTATGGACTTC -> ATTGTACCTATGGACTTCT
ATCCCGTAGAATGGTCCGC -> TCCCGTAGAATGGTCCGCC
TGTAGCACGTAGCGTTCTA -> GTAGCACGTAGCGTTCTAA
ATGGACGTGGAGGATGACG -> TGGACGTGGAGGATGACGG
CTTCTGATGAGAAAAATTG -> TTCTGATGAGAAAAATTGA
CAGGCATGTAGCTATAGGA -> AGGCATGTAGCTATAGGAA
AGACATTAGGATGGGCCGG -> GACATTAGGATGGGCCGGA
GACTGGGTACAAGAGGTTG -> ACTGGGTACAAGAGGTTGC
GTGAAGCGTGTGATGGTTT -> TGAAGCGTGTGATGGTTTT
GTACCTATGGACTTCTTAA -> TACCTATGGACTTCTTAAG
GTGGAACTCATTAACAATG -> TGGAACTCATTAACAATGA
TGTGCGCATAACGAGGGTT -> GTGCGCATAACGAGGGTTC
GAATCATAAAGTCGCCCAC -> AATCATAAAGTCGCCCACG
TAGTGTCAGGTCAGTCGAA -> AGTGTCAGGTCAGTCGAAT
ATAAGTTTTCGATTCCACC -> TAAGTTTTCGATTCCACCA
AAACGCAGGTCCGTGTAAA -> AACGCAGGTCCGTGTAAAC
ACTTCTTAAGGTCGGGTAA -> CTTCTTAAGGTCGGGTAAC
ATCCGGCGTACTGATCACC -> TCCGGCGTACTGATCACCC
GCCCCGAGCCATTCTGTAT -> CCCCGAGCCATTCTGTATA
AGTTATCGATGCGCGGTAG -> GTTATCGATGCGCGGTAGT
CACGCATACAGGGTCATAA -> ACGCATACAGGGTCATAAG
ACGAGGGTTCCTGTTGCTT -> CGAGGGTTCCTGTTGCTTA
CATAGTGTCAGGTCAGTCG -> ATAGTGTCAGGTCAGTCGA
TACTCTAGACAAGTCGGCG -> ACTCTAGACAAGTCGGCGT
ATTACCGTGGGAGAACAAA -> TTACCGTGGGAGAACAAAC
AGGCTGTGCCCGCACACTG -> GGCTGTGCCCGCACACTGC
TTCTACCATTGAGCTCCAT -> TCTACCATTGAGCTCCATG
CATTGAGCTCCATGAGCAA -> ATTGAGCTCCATGAGCAAA
ATCGGGGAACACGGTTATT -> TCGGGGAACACGGTTATTC
CTGGGTACAAGAGGTTGCG -> TGGGTACAAGAGGTTGCGT
GCCCGCACACTGCGCGTCA -> CCCGCACACTGCGCGTCAT
TCTAGAACCTCAATCCGAA -> CTAGAACCTCAATCCGAAT
TTTCGATCTAGAACCTCAA -> TTCGATCTAGAACCTCAAT
AGAGCGAGACTAGTCAAGA -> GAGCGAGACTAGTCAAGAA
CGTTTTTCCAATGCAAATG -> GTTTTTCCAATGCAAATGC
TAGCCCCGAACTGATTAGA -> AGCCCCGAACTGATTAGAA
CGGGTTATCATTAGCAATC -> GGGTTATCATTAGCAATCG
AGAAGGTCAAAGTCTCCGG -> GAAGGTCAAAGTCTCCGGA
ATACTCGACAGATCACTCC -> TACTCGACAGATCACTCCG
AACGTCTTGTTGGGATACA -> ACGTCTTGTTGGGATACAG
ACACCATCTACCCCTGATA -> CACCATCTACCCCTGATAT
CTATGGACTTCTTAAGGTC -> TATGGACTTCTTAAGGTCG
GCAGGCGATGACGGATAAG -> CAGGCGATGACGGATAAGT
AATATACGCTTCTCGCTTA -> ATATACGCTTCTCGCTTAG
TCTTGCTAGAGCCAGGTGG -> CTTGCTAGAGCCAGGTGGA
AATAGTGATTAGTATACAC -> ATAGTGATTAGTATACACC
TGGAGGATGACGGCTTAGT -> GGAGGATGACGGCTTAGTT
AAAAATTGATAAATTGGGA -> AAAATTGATAAATTGGGAA
AGTTTTCGATTCCACCACC -> GTTTTCGATTCCACCACCG
GTGACGAAGGAGTATATAA -> TGACGAAGGAGTATATAAC
ATCACTCCGGACACCCTTA -> TCACTCCGGACACCCTTAA
AATTATGATAGTCGGATAG -> ATTATGATAGTCGGATAGC
ATATAACATGTATATGGCA -> TATAACATGTATATGGCAT
TGTGGGCCTGTTTATAGGC -> GTGGGCCTGTTTATAGGCT
AAGATGGAAGACTGGGTAC -> AGATGGAAGACTGGGTACA
CAACTCCAGGCATGTAGCT -> AACTCCAGGCATGTAGCTA
TCAACCTTAAGCGGGGTTT -> CAACCTTAAGCGGGGTTTG
CGGAATATACGCTTCTCGC -> GGAATATACGCTTCTCGCT
ATATTGTACCTATGGACTT -> TATTGTACCTATGGACTTC
TTACCCGAGTAACCTAGAA -> TACCCGAGTAACCTAGAAG
GTCGCACCGGGCCTGGATT -> TCGCACCGGGCCTGGATTA
GGCTTAGTTGAAATAATGT -> GCTTAGTTGAAATAATGTG
CTCTCTTAAATCGGGGAAC -> TCTCTTAAATCGGGGAACA
CGCTTCTCGCTTAGTTATC -> GCTTCTCGCTTAGTTATCG
GGCTGTGCCCGCACACTGC -> GCTGTGCCCGCACACTGCG
TAAGTCGTTCGCAGAGATA -> AAGTCGTTCGCAGAGATAA
CATACTCGACAGATCACTC -> ATACTCGACAGATCACTCC
CCCTATATGGTCACCACGA -> CCTATATGGTCACCACGAT
AGGTCAGTCGAATTAATTA -> GGTCAGTCGAATTAATTAC
AATTTGATGTTACTCTAGA -> ATTTGATGTTACTCTAGAC
ACCAAGAATCATAAAGTCG -> CCAAGAATCATAAAGTCGC
AAGAACAGTCTGATCGGGT -> AGAACAGTCTGATCGGGTT
ATGCGCGGTAGTGACGAAG -> TGCGCGGTAGTGACGAAGG
CTTTGTGGGCCTGTTTATA -> TTTGTGGGCCTGTTTATAG
CACAAGTCATCATGTAAGA -> ACAAGTCATCATGTAAGAT
GAAGGACCAAGAATCATAA -> AAGGACCAAGAATCATAAA
ACTTCTGATGAGAAAAATT -> CTTCTGATGAGAAAAATTG
TCGCCCACGGCCAGTATTA -> CGCCCACGGCCAGTATTAT
TCACTTCTCTCTCGCCCGG -> CACTTCTCTCTCGCCCGGG
CTTCAGCTCTCTTAAATCG -> TTCAGCTCTCTTAAATCGG
TGGGTAGCCCCTTCGCTTA -> GGGTAGCCCCTTCGCTTAG
GTATTATGTACCGTAACGA -> TATTATGTACCGTAACGAA,TATTATGTACCGTAACGAA
ATGCACGCATACAGGGTCA -> TGCACGCATACAGGGTCAT
TTATGTACCGTAACGAATA -> TATGTACCGTAACGAATAA
AGATCACTCCGGACACCCT -> GATCACTCCGGACACCCTT
ATCAAGTGGCCCCTCAGTA -> TCAAGTGGCCCCTCAGTAG
CGAATAAAGACCGGGTGTG -> GAATAAAGACCGGGTGTGT
TGTAAACACATGCACCCCC -> GTAAACACATGCACCCCCC
GTGTTGCCTCCACAAGTCA -> TGTTGCCTCCACAAGTCAT
CTACCCCTGATATTGTACC -> TACCCCTGATATTGTACCT
GGATCGACGCATGAGATAT -> GATCGACGCATGAGATATA
GACATGCACGCATACAGGG -> ACATGCACGCATACAGGGT
CGAATTATGTACCGTAACG -> GAATTATGTACCGTAACGA
GTAAACACATGCACCCCCC -> TAAACACATGCACCCCCCC
TAGTTTGCAGTATCAGACT -> AGTTTGCAGTATCAGACTC
CGAATCCCAAGGCTAGGGT -> GAATCCCAAGGCTAGGGTG
CCGTTACCCGAGTAACCTA -> CGTTACCCGAGTAACCTAG
AGTAACCTAGAAGGTCCCC -> GTAACCTAGAAGGTCCCCA
TTATACAAGAATCATAAAG -> TATACAAGAATCATAAAGT
GCCATCTCATGTCGATATT -> CCATCTCATGTCGATATTT
GCCGTTGTGACTTTCTTTA -> CCGTTGTGACTTTCTTTAC
GGCGATGACGGATAAGTTT -> GCGATGACGGATAAGTTTT
CCAAGGCTAGGGTGGCCAT -> CAAGGCTAGGGTGGCCATC
TCGATCGCACGTAAAGAAG -> CGATCGCACGTAAAGAAGA
AGTGGCCCCTCAGTAGGAC -> GTGGCCCCTCAGTAGGACA
CCTGATATTGTACCTATGG -> CTGATATTGTACCTATGGA
GATGGTTTTTCTATAATGA -> ATGGTTTTTCTATAATGAT
AACCAACTTCTGATGAGAA -> ACCAACTTCTGATGAGAAA
TCCGTGTAAACACATGCAC -> CCGTGTAAACACATGCACC
ACGCAGGTCCGTGTAAACA -> CGCAGGTCCGTGTAAACAC
GTAACCTAGAAGGTCCCCA -> TAACCTAGAAGGTCCCCAC
TAATTAGGAGCCAACGGCC -> AATTAGGAGCCAACGGCCT
ACGAATAAAGACCGGGTGT -> CGAATAAAGACCGGGTGTG
GTCCCCACTCTGGAAATCC -> TCCCCACTCTGGAAATCCG
GAATATACGCTTCTCGCTT -> AATATACGCTTCTCGCTTA
TCACCACGATAATTCGGGT -> CACCACGATAATTCGGGTA
ACACGGTTATTCTACCATT -> CACGGTTATTCTACCATTG
GCACCCCCCCCTTCCGGTC -> CACCCCCCCCTTCCGGTCG
GAAGACTGGGTACAAGAGG -> AAGACTGGGTACAAGAGGT
TGATGAGTGTTGCCTCCAC -> GATGAGTGTTGCCTCCACA
CATCTCATGTCGATATTTC -> ATCTCATGTCGATATTTCC
GTAGGACCGTATTATGTAC -> TAGGACCGTATTATGTACC
AGAATACGCGATCCCGTAG -> GAATACGCGATCCCGTAGA
GCCGTCCCCGAATTATGTA -> CCGTCCCCGAATTATGTAC
TAGGAGCCAACGGCCTCAG -> AGGAGCCAACGGCCTCAGC
GATAGCCCCGAACTGATTA -> ATAGCCCCGAACTGATTAG
TACACCATCTACCCCTGAT -> ACACCATCTACCCCTGATA
CGTATCAGACAACTCCAGG -> GTATCAGACAACTCCAGGC
AACGAACTATCAACCTTAA -> ACGAACTATCAACCTTAAG
CGTCATATTCGCTGCAATG -> GTCATATTCGCTGCAATGT
GTTATTCTACCATTGAGCT -> TTATTCTACCATTGAGCTC
ATCACACCGCATCTTGCTA -> TCACACCGCATCTTGCTAG
CATATTCGCTGCAATGTGC -> ATATTCGCTGCAATGTGCG
CGGCATCGAGGCTGCAACG -> GGCATCGAGGCTGCAACGT
GTCTATAGCATCACACCGC -> TCTATAGCATCACACCGCA
CCTATATGGTCACCACGAT -> CTATATGGTCACCACGATA
TAAGGTCGGGTAACGTCTT -> AAGGTCGGGTAACGTCTTG
CATGAACAGCTACCTATCC -> ATGAACAGCTACCTATCCC
GGTATGTGAGTCCTACACA -> GTATGTGAGTCCTACACAC
GAGACTAGTCAAGAATCAT -> AGACTAGTCAAGAATCATA
CGAATTTGATGTTACTCTA -> GAATTTGATGTTACTCTAG
ATTGCCGCAAAGAGGGCTC -> TTGCCGCAAAGAGGGCTCA
AGCGTTCTAATCAATCAAC -> GCGTTCTAATCAATCAACG
AGGAGCCAACGGCCTCAGC -> GGAGCCAACGGCCTCAGCC
AACGCGAACGACAGTGTAG -> ACGCGAACGACAGTGTAGT
ATGCAGGAATCTGCCAGCT -> TGCAGGAATCTGCCAGCTC
AGGATGGGCCGGATTCGTT -> GGATGGGCCGGATTCGTTA
GGCGCCATTATATAGCAAC -> GCGCCATTATATAGCAACC
TATTATGTACCGTAACGAA -> ATTATGTACCGTAACGAAT,ATTATGTACCGTAACGAAT
AAGGACCAAGAATCATAAA -> AGGACCAAGAATCATAAAG
TAGGGTGGCCATCTCATGT -> AGGGTGGCCATCTCATGTC
CCCCACTCTGGAAATCCGT -> CCCACTCTGGAAATCCGTG
TCGGGTAAATCATGCGGGT -> CGGGTAAATCATGCGGGTT
CGGATCCGCGCCCATGACT -> GGATCCGCGCCCATGACTA
GCGAGACTAGTCAAGAATC -> CGAGACTAGTCAAGAATCA
TATACTAACGAACTATCAA -> ATACTAACGAACTATCAAC
TTGAGTCACTCTTTTATTC -> TGAGTCACTCTTTTATTCC
TTTCTATAATGATTGCCGC -> TTCTATAATGATTGCCGCA
TTAAATCGGGGAACACGGT -> TAAATCGGGGAACACGGTT
TATCAGACTCTGTAGCACG -> ATCAGACTCTGTAGCACGT
GTCCGTGTAAACACATGCA -> TCCGTGTAAACACATGCAC
ATTGAGCTCCATGAGCAAA -> TTGAGCTCCATGAGCAAAT
GGTTCAGGAAGAAGGTCAA -> GTTCAGGAAGAAGGTCAAA
TGCCTCCACAAGTCATCAT -> GCCTCCACAAGTCATCATG
TAAGAACAGTCTGATCGGG -> AAGAACAGTCTGATCGGGT
GGTAACGTCTTGTTGGGAT -> GTAACGTCTTGTTGGGATA
GAGAACCGTCTCGTAGGAA -> AGAACCGTCTCGTAGGAAT
CGCTCCTGTGTGAAGCGTG -> GCTCCTGTGTGAAGCGTGT
CGCCGTCCCCGAATTATGT -> GCCGTCCCCGAATTATGTA
GCTCAGGCGTTACTTACCG -> CTCAGGCGTTACTTACCGG
TCAACGGATCCGCGCCCAT -> CAACGGATCCGCGCCCATG
CCACCGTTAATTAGGAGCC -> CACCGTTAATTAGGAGCCA
TCCGGAATATACGCTTCTC -> CCGGAATATACGCTTCTCG
ATCCCTCGCCGAAATTGTC -> TCCCTCGCCGAAATTGTCC
AGGACACCGTTCACTGGAG -> GGACACCGTTCACTGGAGG
TCAGGTCAGTCGAATTAAT -> CAGGTCAGTCGAATTAATT
CTATCCCTCGCCGAAATTG -> TATCCCTCGCCGAAATTGT
CGATTCCACCACCGTTAAT -> GATTCCACCACCGTTAATT
TCCAGGCATGTAGCTATAG -> CCAGGCATGTAGCTATAGG
AGTCGGCGTCAGCTCTATA -> GTCGGCGTCAGCTCTATAG
TGTAGGACCGTATTATGTA -> GTAGGACCGTATTATGTAC
GACTCTGGGTAGCCCCTTC -> ACTCTGGGTAGCCCCTTCG
GGAAGACTGGGTACAAGAG -> GAAGACTGGGTACAAGAGG
GAAATCCGTGAGCAAGAAT -> AAATCCGTGAGCAAGAATC
AACAATGATGAGTGTTGCC -> ACAATGATGAGTGTTGCCT
GCGAGACTGCCGTTGTGAC -> CGAGACTGCCGTTGTGACT
AAGACTGGGTACAAGAGGT -> AGACTGGGTACAAGAGGTT
TTACCGTGGGAGAACAAAC -> TACCGTGGGAGAACAAACG
TGGGCCTGTTTATAGGCTG -> GGGCCTGTTTATAGGCTGT
GAACACCTTTTTTCGATCT -> AACACCTTTTTTCGATCTA
TAGAACCTCAATCCGAATT -> AGAACCTCAATCCGAATTA
GCGATCCCGTAGAATGGTC -> CGATCCCGTAGAATGGTCC
CCCGAGTAACCTAGAAGGT -> CCGAGTAACCTAGAAGGTC
GTCAGTCGAATTAATTACC -> TCAGTCGAATTAATTACCG
GTCGATCAGCTATGATCTG -> TCGATCAGCTATGATCTGA
GACAACTCCAGGCATGTAG -> ACAACTCCAGGCATGTAGC
CTCCTGTGTGAAGCGTGTG -> TCCTGTGTGAAGCGTGTGA
ATAGCATCACACCGCATCT -> TAGCATCACACCGCATCTT
TCTCTTAAATCGGGGAACA -> CTCTTAAATCGGGGAACAC
CGCGAGACTGCCGTTGTGA -> GCGAGACTGCCGTTGTGAC
GGACACCGTTCACTGGAGG -> GACACCGTTCACTGGAGGT
CCGCAAAAGCCCTCATGAA -> CGCAAAAGCCCTCATGAAC
CATGAGCAAATTAGCCTGA -> ATGAGCAAATTAGCCTGAT
AATCATGCGGGTTCCAAAA -> ATCATGCGGGTTCCAAAAG
GAAATTGTCCATACTCCGT -> AAATTGTCCATACTCCGTT
CGTGTGATGGTTTTTCTAT -> GTGTGATGGTTTTTCTATA
TCGAATTAATTACCGTGGG -> CGAATTAATTACCGTGGGA
GCATGTAGCTATAGGAAGG -> CATGTAGCTATAGGAAGGT
ACCGTTAATTAGGAGCCAA -> CCGTTAATTAGGAGCCAAC
CCTTAAGCGGGGTTTGAGT -> CTTAAGCGGGGTTTGAGTC
AAATCATGCGGGTTCCAAA -> AATCATGCGGGTTCCAAAA
TGCTGTTTTAGAGCCGGAA -> GCTGTTTTAGAGCCGGAAG
TGGCCCCTCAGTAGGACAT -> GGCCCCTCAGTAGGACATA
TCGATATTTCCGGTGATCC -> CGATATTTCCGGTGATCCA
GATAATTCGGGTAAATCAT -> ATAATTCGGGTAAATCATG
CGCTCATACTCGACAGATC -> GCTCATACTCGACAGATCA
ACGGCCAGTATTATGTACC -> CGGCCAGTATTATGTACCG
TCGTATACTAACGAACTAT -> CGTATACTAACGAACTATC
CCGCGAGACTGCCGTTGTG -> CGCGAGACTGCCGTTGTGA
CTAATCAATCAACGGATCC -> TAATCAATCAACGGATCCG
GTCAGGTCAGTCGAATTAA -> TCAGGTCAGTCGAATTAAT
CTGATATTGTACCTATGGA -> TGATATTGTACCTATGGAC
AGTGGTATCTGCCCGCAAA -> GTGGTATCTGCCCGCAAAA
ATGTATATGGCATTCTGCG -> TGTATATGGCATTCTGCGT
AACCGTCTCGTAGGAATAG -> ACCGTCTCGTAGGAATAGT
AATAGTTAGTTTGCAGTAT -> ATAGTTAGTTTGCAGTATC
TGATAGTCGGATAGCCCCG -> GATAGTCGGATAGCCCCGA
TTTTTCGATCTAGAACCTC -> TTTTCGATCTAGAACCTCA
GAATCTGCCAGCTCACTTC -> AATCTGCCAGCTCACTTCT
AATTGATAAATTGGGAACA -> ATTGATAAATTGGGAACAC
ATGGCGCCATTATATAGCA -> TGGCGCCATTATATAGCAA
GATGCGCGGTAGTGACGAA -> ATGCGCGGTAGTGACGAAG
TGCAAATGCAGGAATCTGC -> GCAAATGCAGGAATCTGCC
CTGTGTGAAGCGTGTGATG -> TGTGTGAAGCGTGTGATGG
GTCAAGGACCGCGTCCGCG -> TCAAGGACCGCGTCCGCGA
GTCGCCCACGGCCAGTATT -> TCGCCCACGGCCAGTATTA
CGTTACCCGAGTAACCTAG -> GTTACCCGAGTAACCTAGA
ATCAGACTCTGTAGCACGT -> TCAGACTCTGTAGCACGTA
ACCCGAGTAACCTAGAAGG -> CCCGAGTAACCTAGAAGGT
AAAGAGGGCTCAGGCGTTA -> AAGAGGGCTCAGGCGTTAC
TTCAGCTCTCTTAAATCGG -> TCAGCTCTCTTAAATCGGG
ATGGTTGGCTACGCTTCGC -> TGGTTGGCTACGCTTCGCT
TATAATGATTGCCGCAAAG -> ATAATGATTGCCGCAAAGA
AATCTGCCAGCTCACTTCT -> ATCTGCCAGCTCACTTCTC
CGCCCATGACTAAGTCGTT -> GCCCATGACTAAGTCGTTC
AATACGCGATCCCGTAGAA -> ATACGCGATCCCGTAGAAT
CAAAAGCCCTCATGAACAG -> AAAAGCCCTCATGAACAGC
TACGGTATGTGAGTCCTAC -> ACGGTATGTGAGTCCTACA
GGCGTTACTTACCGGTCGT -> GCGTTACTTACCGGTCGTA
AGGCATGTAGCTATAGGAA -> GGCATGTAGCTATAGGAAG
CGGCGTACTGATCACCCGT -> GGCGTACTGATCACCCGTC
GCTGCAACGTCATATTCGC -> CTGCAACGTCATATTCGCT
GGGTTATCATTAGCAATCG -> GGTTATCATTAGCAATCGA
GTGCCCGCACACTGCGCGT -> TGCCCGCACACTGCGCGTC
GCCAGCTCACTTCTCTCTC -> CCAGCTCACTTCTCTCTCG
ACGCTTCGCTCATACTCGA -> CGCTTCGCTCATACTCGAC
CTTCTTAAGGTCGGGTAAC -> TTCTTAAGGTCGGGTAACG
CGAAATTGTCCATACTCCG -> GAAATTGTCCATACTCCGT
AATTGGGAACACCTTTTTT -> ATTGGGAACACCTTTTTTC
ATGGTTCAGGAAGAAGGTC -> TGGTTCAGGAAGAAGGTCA
CCAAAAGGCTCGTCCCGCT -> CAAAAGGCTCGTCCCGCTC
TTGGAATAGTTAGTTTGCA -> TGGAATAGTTAGTTTGCAG
GAGATATAAGCAGCGAGGA -> AGATATAAGCAGCGAGGAC
AAAAGCCCTCATGAACAGC -> AAAGCCCTCATGAACAGCT
TGCGGGTTCCAAAAGGCTC -> GCGGGTTCCAAAAGGCTCG
CCAACGGCCTCAGCCCCGA -> CAACGGCCTCAGCCCCGAG
GTCAGCTCTATAGACATTA -> TCAGCTCTATAGACATTAG
AGTCACTCTTTTATTCCCC -> GTCACTCTTTTATTCCCCT
CCGAATTATGTACCGTAAC -> CGAATTATGTACCGTAACG
ATACTGTATTAATATAATG -> TACTGTATTAATATAATGT
CGTGGAGGATGACGGCTTA -> GTGGAGGATGACGGCTTAG
CCCGGGGATTAGCTTACAT -> CCGGGGATTAGCTTACATA
TCGAGGCTGCAACGTCATA -> CGAGGCTGCAACGTCATAT
CTGCCAGCTCACTTCTCTC -> TGCCAGCTCACTTCTCTCT
TCTCTCGCCCGGGGATTAG -> CTCTCGCCCGGGGATTAGC
TAGTGACGAAGGAGTATAT -> AGTGACGAAGGAGTATATA
AGGAAGAAGGTCAAAGTCT -> GGAAGAAGGTCAAAGTCTC
GGTAGCCCCTTCGCTTAGG -> GTAGCCCCTTCGCTTAGGT
ATGGGCCGGATTCGTTAAC -> TGGGCCGGATTCGTTAACT
GAAGCGTGTGATGGTTTTT -> AAGCGTGTGATGGTTTTTC
TAGTATACACCATCTACCC -> AGTATACACCATCTACCCC
CCAGTATTATGTACCGTAA -> CAGTATTATGTACCGTAAC
ATGAGAGTGGTATCTGCCC -> TGAGAGTGGTATCTGCCCG
GGAACACCTTTTTTCGATC -> GAACACCTTTTTTCGATCT
TGTGAGTCCTACACACGTT -> GTGAGTCCTACACACGTTT
CTCTATAGACATTAGGATG -> TCTATAGACATTAGGATGG
TGGCATTCTGCGTATCAGA -> GGCATTCTGCGTATCAGAC
CCGCTCCTGTGTGAAGCGT -> CGCTCCTGTGTGAAGCGTG
TTCGCAGAGATAACCACGT -> TCGCAGAGATAACCACGTC
TGGCGCCATTATATAGCAA -> GGCGCCATTATATAGCAAC
TCGCTTAGGTTGGAATAGT -> CGCTTAGGTTGGAATAGTT
TCTCTGGTGTGCGTTTTTC -> CTCTGGTGTGCGTTTTTCC
CCCTTCAGCTCTCTTAAAT -> CCTTCAGCTCTCTTAAATC
GATGACGGCTTAGTTGAAA -> ATGACGGCTTAGTTGAAAT
GTATGTGAGTCCTACACAC -> TATGTGAGTCCTACACACG
TAAAGAAGATGGCGCCATT -> AAAGAAGATGGCGCCATTA
TAAGTTTTCGATTCCACCA -> AAGTTTTCGATTCCACCAC
TGTGACTCTGGGTAGCCCC -> GTGACTCTGGGTAGCCCCT
CATGACTAAGTCGTTCGCA -> ATGACTAAGTCGTTCGCAG
CATTATATAGCAACCAACT -> ATTATATAGCAACCAACTT
TAAGCAGCGAGGACACCGT -> AAGCAGCGAGGACACCGTT
AGAAAGATGGTTGGCTACG -> GAAAGATGGTTGGCTACGC
AGAGGTGGATGCTGTTTTA -> GAGGTGGATGCTGTTTTAG
ACTAAGTCGTTCGCAGAGA -> CTAAGTCGTTCGCAGAGAT
CGCGCCGTCCCCGAATTAT -> GCGCCGTCCCCGAATTATG
GGCGTCAGCTCTATAGACA -> GCGTCAGCTCTATAGACAT
AGACTCTGTAGCACGTAGC -> GACTCTGTAGCACGTAGCG
TTCTATAATGATTGCCGCA -> TCTATAATGATTGCCGCAA
ATGTCGATATTTCCGGTGA -> TGTCGATATTTCCGGTGAT
AATGTGCGCATAACGAGGG -> ATGTGCGCATAACGAGGGT
ACTCCGGACACCCTTAACT -> CTCCGGACACCCTTAACTT
CTCTGGTGTGCGTTTTTCC -> TCTGGTGTGCGTTTTTCCA
ATGATCTGAGACTAAACGC -> TGATCTGAGACTAAACGCG
AGTATATAACATGTATATG -> GTATATAACATGTATATGG
GACCAAGAATCATAAAGTC -> ACCAAGAATCATAAAGTCG
CATGTATATGGCATTCTGC -> ATGTATATGGCATTCTGCG
AATTAATTACCGTGGGAGA -> ATTAATTACCGTGGGAGAA
TTCTAATCAATCAACGGAT -> TCTAATCAATCAACGGATC
GCTTACATAGTGTCAGGTC -> CTTACATAGTGTCAGGTCA
TAGCACGGATCGACGCATG -> AGCACGGATCGACGCATGA
AGGTCTATAGCATCACACC -> GGTCTATAGCATCACACCG
GGATGCTGTTTTAGAGCCG -> GATGCTGTTTTAGAGCCGG
TGGTCACCACGATAATTCG -> GGTCACCACGATAATTCGG
ATGTAAGATGGAAGACTGG -> TGTAAGATGGAAGACTGGG
GGTCGGGTAACGTCTTGTT -> GTCGGGTAACGTCTTGTTG
TGTTGCCTCCACAAGTCAT -> GTTGCCTCCACAAGTCATC
GCTACGCTTCGCTCATACT -> CTACGCTTCGCTCATACTC
CGCCATTATATAGCAACCA -> GCCATTATATAGCAACCAA
AATCATAAAGTCGCACCGG -> ATCATAAAGTCGCACCGGG
CGTCCCCGAATTATGTACC -> GTCCCCGAATTATGTACCG
GAACAAACGCAGGTCCGTG -> AACAAACGCAGGTCCGTGT
GCCCTTCAGCTCTCTTAAA -> CCCTTCAGCTCTCTTAAAT
GTTAACTCAGCGCACTTTG -> TTAACTCAGCGCACTTTGT
GCTCATACTCGACAGATCA -> CTCATACTCGACAGATCAC
TCCTGTGTGAAGCGTGTGA -> CCTGTGTGAAGCGTGTGAT
TGATATTGTACCTATGGAC -> GATATTGTACCTATGGACT
AGGTTGCGTCAAGGACCGC -> GGTTGCGTCAAGGACCGCG
TATATAACATGTATATGGC -> ATATAACATGTATATGGCA
TCGGGTAACGTCTTGTTGG -> CGGGTAACGTCTTGTTGGG
TCAAGTGGCCCCTCAGTAG -> CAAGTGGCCCCTCAGTAGG
CGGTCGGCCCTTCAGCTCT -> GGTCGGCCCTTCAGCTCTC
CGCGTCATGGACGTGGAGG -> GCGTCATGGACGTGGAGGA
CGACGCATGAGATATAAGC -> GACGCATGAGATATAAGCA
TACCGTAACGAATTCGGCA -> ACCGTAACGAATTCGGCAT
ACACCGTTCACTGGAGGTT -> CACCGTTCACTGGAGGTTA
ACAGCATCGATCGCACGTA -> CAGCATCGATCGCACGTAA
CCTCAATCCGAATTATGAT -> CTCAATCCGAATTATGATA
GATGACGGATAAGTTTTCG -> ATGACGGATAAGTTTTCGA
CCGGTCGGCCCTTCAGCTC -> CGGTCGGCCCTTCAGCTCT
CATAACGAGGGTTCCTGTT -> ATAACGAGGGTTCCTGTTG
AAAGTCGCACCGGGCCTGG -> AAGTCGCACCGGGCCTGGA
TTATGTACCGTAACGAATC -> TATGTACCGTAACGAATCC
CCCGAACTGATTAGAATAC -> CCGAACTGATTAGAATACT
AGCCCCTTCGCTTAGGTTG -> GCCCCTTCGCTTAGGTTGG
CCAGCTCACTTCTCTCTCG -> CAGCTCACTTCTCTCTCGC
TCACTGGAGGTTATGTATC -> CACTGGAGGTTATGTATCA
GACATTAGGATGGGCCGGA -> ACATTAGGATGGGCCGGAT
GTGACTTTCTTTACATTCC -> TGACTTTCTTTACATTCCT
TAGGCTGTGCCCGCACACT -> AGGCTGTGCCCGCACACTG
CGAGGCTGCAACGTCATAT -> GAGGCTGCAACGTCATATT
ATGTGAGTCCTACACACGT -> TGTGAGTCCTACACACGTT
AGTGTTGCCTCCACAAGTC -> GTGTTGCCTCCACAAGTCA
AGAGCCGGAAGGACCAAGA -> GAGCCGGAAGGACCAAGAA
AAGTGGCCCCTCAGTAGGA -> AGTGGCCCCTCAGTAGGAC
AAAGTCGCTGTAGGACCGT -> AAGTCGCTGTAGGACCGTA
TCATTAGCAATCGACATGC -> CATTAGCAATCGACATGCA
TGTATTAATATAATGTGGC -> GTATTAATATAATGTGGCT
CCCACAGCATCGATCGCAC -> CCACAGCATCGATCGCACG
GAGCCATTCTGTATAGAGA -> AGCCATTCTGTATAGAGAA
CATGTAAGATGGAAGACTG -> ATGTAAGATGGAAGACTGG
CGCATCTTGCTAGAGCCAG -> GCATCTTGCTAGAGCCAGG
CTCAATCCGAATTATGATA -> TCAATCCGAATTATGATAG
ATATGGCATTCTGCGTATC -> TATGGCATTCTGCGTATCA
TGGAATCCGGCGTACTGAT -> GGAATCCGGCGTACTGATC
CAACGTCATATTCGCTGCA -> AACGTCATATTCGCTGCAA
CCAAGAATCATAAAGTCGC -> CAAGAATCATAAAGTCGCC
GCCTGGATTATGTACCGTA -> CCTGGATTATGTACCGTAA
TGGAAGACTGGGTACAAGA -> GGAAGACTGGGTACAAGAG
ATTCCACCACCGTTAATTA -> TTCCACCACCGTTAATTAG
ATAGGAAGGTCTATAGCAT -> TAGGAAGGTCTATAGCATC
CTCGTCCCGCTCCTGTGTG -> TCGTCCCGCTCCTGTGTGA
ATCCCAAGGCTAGGGTGGC -> TCCCAAGGCTAGGGTGGCC
CGCGTCCGCGAGACTGCCG -> GCGTCCGCGAGACTGCCGT
CACTCCGGACACCCTTAAC -> ACTCCGGACACCCTTAACT
GGAATAGTGATTAGTATAC -> GAATAGTGATTAGTATACA
TATACAAGAATCATAAAGT -> ATACAAGAATCATAAAGTC
GCGGGTTCCAAAAGGCTCG -> CGGGTTCCAAAAGGCTCGT
AATCAACGGATCCGCGCCC -> ATCAACGGATCCGCGCCCA
CACTCTTTTATTCCCCTGT -> ACTCTTTTATTCCCCTGTC
ATACGCTTCTCGCTTAGTT -> TACGCTTCTCGCTTAGTTA
GATTAGTATACACCATCTA -> ATTAGTATACACCATCTAC
GAATCATAAAGTCGCTGTA -> AATCATAAAGTCGCTGTAG
TATAATGTGGCTTAATCTC -> ATAATGTGGCTTAATCTCT
TATAGGAAGGTCTATAGCA -> ATAGGAAGGTCTATAGCAT
GTATATGGCATTCTGCGTA -> TATATGGCATTCTGCGTAT
ACCAACTTCTGATGAGAAA -> CCAACTTCTGATGAGAAAA
TCCCCTGTCGATCAGCTAT -> CCCCTGTCGATCAGCTATG
GTGAGTCCTACACACGTTT -> TGAGTCCTACACACGTTTA
ATTATGTACCGTAACGAAT -> TTATGTACCGTAACGAATT,TTATGTACCGTAACGAATT,TTATGTACCGTAACGAATA,TTATGTACCGTAACGAATC
TCATGTCGATATTTCCGGT -> CATGTCGATATTTCCGGTG
TACCCCTGATATTGTACCT -> ACCCCTGATATTGTACCTA
ACCTTTTTTCGATCTAGAA -> CCTTTTTTCGATCTAGAAC
CCACTCTGGAAATCCGTGA -> CACTCTGGAAATCCGTGAG
ACAGCTACCTATCCCTCGC -> CAGCTACCTATCCCTCGCC
GTCACCACGATAATTCGGG -> TCACCACGATAATTCGGGT
GACTAAGTCGTTCGCAGAG -> ACTAAGTCGTTCGCAGAGA
GGGTTTGAGTCACTCTTTT -> GGTTTGAGTCACTCTTTTA
TGATCGGGTTATCATTAGC -> GATCGGGTTATCATTAGCA
TCTAGACAAGTCGGCGTCA -> CTAGACAAGTCGGCGTCAG
TTTGCAGTATCAGACTCTG -> TTGCAGTATCAGACTCTGT
TTATATAGCAACCAACTTC -> TATATAGCAACCAACTTCT
CATTAGCAATCGACATGCA -> ATTAGCAATCGACATGCAC
CTTAGGTTGGAATAGTTAG -> TTAGGTTGGAATAGTTAGT
TTTGAGTCACTCTTTTATT -> TTGAGTCACTCTTTTATTC
TATGTGAGTCCTACACACG -> ATGTGAGTCCTACACACGT
TATGATAGTCGGATAGCCC -> ATGATAGTCGGATAGCCCC
GTCAAGAATCATAAAGTCG -> TCAAGAATCATAAAGTCGC
TGGCCATCTCATGTCGATA -> GGCCATCTCATGTCGATAT
AGAACAAACGCAGGTCCGT -> GAACAAACGCAGGTCCGTG
TATCAACCTTAAGCGGGGT -> ATCAACCTTAAGCGGGGTT
TGTACCTATGGACTTCTTA -> GTACCTATGGACTTCTTAA
TGATCTGAGACTAAACGCG -> GATCTGAGACTAAACGCGA
TAATCTCTGGTGTGCGTTT -> AATCTCTGGTGTGCGTTTT
AAGGCTCGTCCCGCTCCTG -> AGGCTCGTCCCGCTCCTGT
ATCTGCCCGCAAAAGCCCT -> TCTGCCCGCAAAAGCCCTC
AGAACCGTCTCGTAGGAAT -> GAACCGTCTCGTAGGAATA
GTGGGCCTGTTTATAGGCT -> TGGGCCTGTTTATAGGCTG
GCGTATCAGACAACTCCAG -> CGTATCAGACAACTCCAGG
CTGCGTATCAGACAACTCC -> TGCGTATCAGACAACTCCA
TTTTTTCGATCTAGAACCT -> TTTTTCGATCTAGAACCTC
AACGAATTCGGCATCGAGG -> ACGAATTCGGCATCGAGGC
CCGGAAGGACCAAGAATCA -> CGGAAGGACCAAGAATCAT
TATGAGAGTGGTATCTGCC -> ATGAGAGTGGTATCTGCCC
GAGTGGTATCTGCCCGCAA -> AGTGGTATCTGCCCGCAAA
ATATAATGTGGCTTAATCT -> TATAATGTGGCTTAATCTC
AATGGTCCGCCGCAGGCGA -> ATGGTCCGCCGCAGGCGAT
CGCACCGGGCCTGGATTAT -> GCACCGGGCCTGGATTATG
AAAAGGCTCGTCCCGCTCC -> AAAGGCTCGTCCCGCTCCT
CAGGTCAGTCGAATTAATT -> AGGTCAGTCGAATTAATTA
CGATATTTCCGGTGATCCA -> GATATTTCCGGTGATCCAG
CGCTTAGTTATCGATGCGC -> GCTTAGTTATCGATGCGCG
TCGATCTAGAACCTCAATC -> CGATCTAGAACCTCAATCC
AGCGGGGTTTGAGTCACTC -> GCGGGGTTTGAGTCACTCT
TTAAGCGGGGTTTGAGTCA -> TAAGCGGGGTTTGAGTCAC
TGTACCGTAACGAATCCCA -> GTACCGTAACGAATCCCAA
GCAAAGAGGGCTCAGGCGT -> CAAAGAGGGCTCAGGCGTT
ACGAATCCCAAGGCTAGGG -> CGAATCCCAAGGCTAGGGT
GCATCTTGCTAGAGCCAGG -> CATCTTGCTAGAGCCAGGT
ATCTAGAACCTCAATCCGA -> TCTAGAACCTCAATCCGAA
GGAACTCATTAACAATGAT -> GAACTCATTAACAATGATG
GAGTATATAACATGTATAT -> AGTATATAACATGTATATG
AATTATGTACCGTAACGAA -> ATTATGTACCGTAACGAAT
TTATGATAGTCGGATAGCC -> TATGATAGTCGGATAGCCC
TCATCATGTAAGATGGAAG -> CATCATGTAAGATGGAAGA
ACCGTAACGAATCCCAAGG -> CCGTAACGAATCCCAAGGC
AGGTCCGTGTAAACACATG -> GGTCCGTGTAAACACATGC
ATACTCCGTTACCCGAGTA -> TACTCCGTTACCCGAGTAA
AATCATAAAGTCGCCCACG -> ATCATAAAGTCGCCCACGG
AGTCGTTCGCAGAGATAAC -> GTCGTTCGCAGAGATAACC
GGTGTGTATGGTTCAGGAA -> GTGTGTATGGTTCAGGAAG
TCAAGGACCGCGTCCGCGA -> CAAGGACCGCGTCCGCGAG
CGCAAAAGCCCTCATGAAC -> GCAAAAGCCCTCATGAACA
AGGTCAAAGTCTCCGGAAT -> GGTCAAAGTCTCCGGAATA
GCCAGTATTATGTACCGTA -> CCAGTATTATGTACCGTAA
TATGTATCAAGTGGCCCCT -> ATGTATCAAGTGGCCCCTC
ACAAGAGGTTGCGTCAAGG -> CAAGAGGTTGCGTCAAGGA
AGGACCGTATTATGTACCG -> GGACCGTATTATGTACCGT
GACAGATCACTCCGGACAC -> ACAGATCACTCCGGACACC
ACCGTGGGAGAACAAACGC -> CCGTGGGAGAACAAACGCA
GATCACTCCGGACACCCTT -> ATCACTCCGGACACCCTTA
ATCCAGAAAGATGGTTGGC -> TCCAGAAAGATGGTTGGCT
AGGAAGGTCTATAGCATCA -> GGAAGGTCTATAGCATCAC
ACGACAGTGTAGTGGAATC -> CGACAGTGTAGTGGAATCC
CTGATTAGAATACTGTATT -> TGATTAGAATACTGTATTA
TGTCGATCAGCTATGATCT -> GTCGATCAGCTATGATCTG
GAATACGCGATCCCGTAGA -> AATACGCGATCCCGTAGAA
TTCCTGTTGCTTAAGAACA -> TCCTGTTGCTTAAGAACAG
GGCTACGCTTCGCTCATAC -> GCTACGCTTCGCTCATACT
GCACGTAAAGAAGATGGCG -> CACGTAAAGAAGATGGCGC
GGTTCCAAAAGGCTCGTCC -> GTTCCAAAAGGCTCGTCCC
GCACGTAGCGTTCTAATCA -> CACGTAGCGTTCTAATCAA
CTGTATAGAGAACCGTCTC -> TGTATAGAGAACCGTCTCG
GCAGGAATCTGCCAGCTCA -> CAGGAATCTGCCAGCTCAC
TCGCTGCAATGTGCGCATA -> CGCTGCAATGTGCGCATAA
GGTTGGAATAGTTAGTTTG -> GTTGGAATAGTTAGTTTGC
GTAGTGGAATCCGGCGTAC -> TAGTGGAATCCGGCGTACT
GACCGCGTCCGCGAGACTG -> ACCGCGTCCGCGAGACTGC
GGGTGTGGGATTAGAGGTG -> GGTGTGGGATTAGAGGTGG
TTATGAGAGTGGTATCTGC -> TATGAGAGTGGTATCTGCC
TGATGTTACTCTAGACAAG -> GATGTTACTCTAGACAAGT
ATACACCATCTACCCCTGA -> TACACCATCTACCCCTGAT
TGGTCCGCCGCAGGCGATG -> GGTCCGCCGCAGGCGATGA
CATGTCGATATTTCCGGTG -> ATGTCGATATTTCCGGTGA
AGCCGGAAGGACCAAGAAT -> GCCGGAAGGACCAAGAATC
GTGTATGGTTCAGGAAGAA -> TGTATGGTTCAGGAAGAAG
CACAGCATCGATCGCACGT -> ACAGCATCGATCGCACGTA
CACTTTGTGGGCCTGTTTA -> ACTTTGTGGGCCTGTTTAT
GCAATTTACGGTATGTGAG -> CAATTTACGGTATGTGAGT
TTCCACCACCGTTAATTAG -> TCCACCACCGTTAATTAGG
GTGGATGCTGTTTTAGAGC -> TGGATGCTGTTTTAGAGCC
TGCCGTTGTGACTTTCTTT -> GCCGTTGTGACTTTCTTTA
CCCTCATGAACAGCTACCT -> CCTCATGAACAGCTACCTA
CCTCGCCGAAATTGTCCAT -> CTCGCCGAAATTGTCCATA
CGGAAGGACCAAGAATCAT -> GGAAGGACCAAGAATCATA
AGGGTCATAAGAGCGAGAC -> GGGTCATAAGAGCGAGACT
AGACTGCCGTTGTGACTTT -> GACTGCCGTTGTGACTTTC
TAGAGGTGGATGCTGTTTT -> AGAGGTGGATGCTGTTTTA
CTAAGTCGTTCGCAGAGAT -> TAAGTCGTTCGCAGAGATA
TATACACCATCTACCCCTG -> ATACACCATCTACCCCTGA
AGCTACCTATCCCTCGCCG -> GCTACCTATCCCTCGCCGA
TCATACTCGACAGATCACT -> CATACTCGACAGATCACTC
ATGACGGATAAGTTTTCGA -> TGACGGATAAGTTTTCGAT
GTATCAAGTGGCCCCTCAG -> TATCAAGTGGCCCCTCAGT
AAACGCGAACGACAGTGTA -> AACGCGAACGACAGTGTAG
GTCCTACACACGTTTATAC -> TCCTACACACGTTTATACA
TCTGGGTAGCCCCTTCGCT -> CTGGGTAGCCCCTTCGCTT
TACCGGTCGTATACTAACG -> ACCGGTCGTATACTAACGA
CGACAGATCACTCCGGACA -> GACAGATCACTCCGGACAC
ATAGAGAACCGTCTCGTAG -> TAGAGAACCGTCTCGTAGG
GTGACTCTGGGTAGCCCCT -> TGACTCTGGGTAGCCCCTT
GGAAGGTCTATAGCATCAC -> GAAGGTCTATAGCATCACA
CCACGGCCAGTATTATGTA -> CACGGCCAGTATTATGTAC
TCCTGTTGCTTAAGAACAG -> CCTGTTGCTTAAGAACAGT
CGGACAGAATACGCGATCC -> GGACAGAATACGCGATCCC
TGTGCCCGCACACTGCGCG -> GTGCCCGCACACTGCGCGT
CGGGGTTTGAGTCACTCTT -> GGGGTTTGAGTCACTCTTT
GTTTTAGAGCCGGAAGGAC -> TTTTAGAGCCGGAAGGACC
ACGTCTTGTTGGGATACAG -> CGTCTTGTTGGGATACAGG
GGCTGCAACGTCATATTCG -> GCTGCAACGTCATATTCGC
TATAGGCTGTGCCCGCACA -> ATAGGCTGTGCCCGCACAC
GAATTATGATAGTCGGATA -> AATTATGATAGTCGGATAG
CAGCGCACTTTGTGGGCCT -> AGCGCACTTTGTGGGCCTG
CCGGACACCCTTAACTTAT -> CGGACACCCTTAACTTATG
ATAAAGTCGCTGTAGGACC -> TAAAGTCGCTGTAGGACCG
TAGCACGTAGCGTTCTAAT -> AGCACGTAGCGTTCTAATC
GTTGCCTCCACAAGTCATC -> TTGCCTCCACAAGTCATCA
ATGACTAAGTCGTTCGCAG -> TGACTAAGTCGTTCGCAGA
AACGAGGGTTCCTGTTGCT -> ACGAGGGTTCCTGTTGCTT
TAAGAGCGAGACTAGTCAA -> AAGAGCGAGACTAGTCAAG
GTGCGTTTTTCCAATGCAA -> TGCGTTTTTCCAATGCAAA
ACATGCACGCATACAGGGT -> CATGCACGCATACAGGGTC
CAGCATCGATCGCACGTAA -> AGCATCGATCGCACGTAAA
TCGCCGAAATTGTCCATAC -> CGCCGAAATTGTCCATACT
GGTATCTGCCCGCAAAAGC -> GTATCTGCCCGCAAAAGCC
TAAAGTCGCTGTAGGACCG -> AAAGTCGCTGTAGGACCGT
ATAGTGTCAGGTCAGTCGA -> TAGTGTCAGGTCAGTCGAA
GTCCCGCTCCTGTGTGAAG -> TCCCGCTCCTGTGTGAAGC
TCCCAAGGCTAGGGTGGCC -> CCCAAGGCTAGGGTGGCCA
GATAAGTTTTCGATTCCAC -> ATAAGTTTTCGATTCCACC
ATTAGTATACACCATCTAC -> TTAGTATACACCATCTACC
GCTTAGTTGAAATAATGTG -> CTTAGTTGAAATAATGTGA
AGCCAACGGCCTCAGCCCC -> GCCAACGGCCTCAGCCCCG
TGTAAGATGGAAGACTGGG -> GTAAGATGGAAGACTGGGT
AGATATAAGCAGCGAGGAC -> GATATAAGCAGCGAGGACA
CCCTGATATTGTACCTATG -> CCTGATATTGTACCTATGG
TCCGGTCGGCCCTTCAGCT -> CCGGTCGGCCCTTCAGCTC
CGGGTGTGTATGGTTCAGG -> GGGTGTGTATGGTTCAGGA
GCTGTGCCCGCACACTGCG -> CTGTGCCCGCACACTGCGC
GCCATTCTGTATAGAGAAC -> CCATTCTGTATAGAGAACC
CTCGCTTAGTTATCGATGC -> TCGCTTAGTTATCGATGCG
CGTCCCCACAGCATCGATC -> GTCCCCACAGCATCGATCG
CTCCATGAGCAAATTAGCC -> TCCATGAGCAAATTAGCCT
GGGGTTTGAGTCACTCTTT -> GGGTTTGAGTCACTCTTTT
GTATACTAACGAACTATCA -> TATACTAACGAACTATCAA
GTTACCCGAGTAACCTAGA -> TTACCCGAGTAACCTAGAA
GAATACTGTATTAATATAA -> AATACTGTATTAATATAAT
ACGGCCTCAGCCCCGAGCC -> CGGCCTCAGCCCCGAGCCA
GGTTTTTCTATAATGATTG -> GTTTTTCTATAATGATTGC
CAGCTCTATAGACATTAGG -> AGCTCTATAGACATTAGGA
AGGGTGTGGGATTAGAGGT -> GGGTGTGGGATTAGAGGTG
ACGAATTCGGCATCGAGGC -> CGAATTCGGCATCGAGGCT
GTAACGAATAAAGACCGGG -> TAACGAATAAAGACCGGGT
ATCTACCCCTGATATTGTA -> TCTACCCCTGATATTGTAC
AGTCTGATCGGGTTATCAT -> GTCTGATCGGGTTATCATT
TGTCAGGTCAGTCGAATTA -> GTCAGGTCAGTCGAATTAA
AAAGTCTCCGGAATATACG -> AAGTCTCCGGAATATACGC
CCCGCTCCTGTGTGAAGCG -> CCGCTCCTGTGTGAAGCGT
GTCATGGACGTGGAGGATG -> TCATGGACGTGGAGGATGA
CGAACTGATTAGAATACTG -> GAACTGATTAGAATACTGT
CAGAATACGCGATCCCGTA -> AGAATACGCGATCCCGTAG
TACTTACCGGTCGTATACT -> ACTTACCGGTCGTATACTA
GTCGCTGTAGGACCGTATT -> TCGCTGTAGGACCGTATTA
ACCGGGCCTGGATTATGTA -> CCGGGCCTGGATTATGTAC
CGGTCGTATACTAACGAAC -> GGTCGTATACTAACGAACT
GTGTCAGGTCAGTCGAATT -> TGTCAGGTCAGTCGAATTA
TGTAGCTATAGGAAGGTCT -> GTAGCTATAGGAAGGTCTA
AATAAAGACCGGGTGTGTA -> ATAAAGACCGGGTGTGTAT
CCGTCGCAATTTACGGTAT -> CGTCGCAATTTACGGTATG
GCAACGTCATATTCGCTGC -> CAACGTCATATTCGCTGCA
GAATGGTCCGCCGCAGGCG -> AATGGTCCGCCGCAGGCGA
GGATTAGCTTACATAGTGT -> GATTAGCTTACATAGTGTC
GATCACCCGTCGCAATTTA -> ATCACCCGTCGCAATTTAC
TTTTCGATTCCACCACCGT -> TTTCGATTCCACCACCGTT
AGAGCCAGGTGGAACTCAT -> GAGCCAGGTGGAACTCATT
GCGCCATTATATAGCAACC -> CGCCATTATATAGCAACCA
GGTAGTGACGAAGGAGTAT -> GTAGTGACGAAGGAGTATA
GATAGTCGGATAGCCCCGA -> ATAGTCGGATAGCCCCGAA
TATTAATATAATGTGGCTT -> ATTAATATAATGTGGCTTA
CCGTAGAATGGTCCGCCGC -> CGTAGAATGGTCCGCCGCA
GGACTTCTTAAGGTCGGGT -> GACTTCTTAAGGTCGGGTA
GAACACGGTTATTCTACCA -> AACACGGTTATTCTACCAT
CTGTGCCCGCACACTGCGC -> TGTGCCCGCACACTGCGCG
AACGCAGGTCCGTGTAAAC -> ACGCAGGTCCGTGTAAACA
ACTCTTTTATTCCCCTGTC -> CTCTTTTATTCCCCTGTCG
CCCCGAACTGATTAGAATA -> CCCGAACTGATTAGAATAC
ATGGACTTCTTAAGGTCGG -> TGGACTTCTTAAGGTCGGG
ACCGCATCTTGCTAGAGCC -> CCGCATCTTGCTAGAGCCA
GAGGACACCGTTCACTGGA -> AGGACACCGTTCACTGGAG
GCAGTATCAGACTCTGTAG -> CAGTATCAGACTCTGTAGC
AGCTATGATCTGAGACTAA -> GCTATGATCTGAGACTAAA
ATTAGCCTGATTATAGCAC -> TTAGCCTGATTATAGCACG
GCATCGAGGCTGCAACGTC -> CATCGAGGCTGCAACGTCA
ACATGCACCCCCCCCTTCC -> CATGCACCCCCCCCTTCCG
GGAATAGTTAGTTTGCAGT -> GAATAGTTAGTTTGCAGTA
TCAATCCGAATTATGATAG -> CAATCCGAATTATGATAGT
CGGGGATTAGCTTACATAG -> GGGGATTAGCTTACATAGT
GCGTTCTAATCAATCAACG -> CGTTCTAATCAATCAACGG
GTTCTAATCAATCAACGGA -> TTCTAATCAATCAACGGAT
GCTCACTTCTCTCTCGCCC -> CTCACTTCTCTCTCGCCCG
GATTCCACCACCGTTAATT -> ATTCCACCACCGTTAATTA
GTTATCGATGCGCGGTAGT -> TTATCGATGCGCGGTAGTG
AGCTATAGGAAGGTCTATA -> GCTATAGGAAGGTCTATAG
CGGCTTAGTTGAAATAATG -> GGCTTAGTTGAAATAATGT
AAAGTCGCCCACGGCCAGT -> AAGTCGCCCACGGCCAGTA
ATCGAGGCTGCAACGTCAT -> TCGAGGCTGCAACGTCATA
GCTCTCTTAAATCGGGGAA -> CTCTCTTAAATCGGGGAAC
GAGACTGCCGTTGTGACTT -> AGACTGCCGTTGTGACTTT
AGTCCTACACACGTTTATA -> GTCCTACACACGTTTATAC
TTTTTCCAATGCAAATGCA -> TTTTCCAATGCAAATGCAG
AAATTGTCCATACTCCGTT -> AATTGTCCATACTCCGTTA
AAGTCATCATGTAAGATGG -> AGTCATCATGTAAGATGGA
GGCCCCTCAGTAGGACATA -> GCCCCTCAGTAGGACATAC
TAAAGTCGCACCGGGCCTG -> AAAGTCGCACCGGGCCTGG
AGTCTCCGGAATATACGCT -> GTCTCCGGAATATACGCTT
GTTGAAATAATGTGACTCT -> TTGAAATAATGTGACTCTG
TTAGGATGGGCCGGATTCG -> TAGGATGGGCCGGATTCGT
TTCTCGCTTAGTTATCGAT -> TCTCGCTTAGTTATCGATG
AGATGGCGCCATTATATAG -> GATGGCGCCATTATATAGC
ACAGGGTCATAAGAGCGAG -> CAGGGTCATAAGAGCGAGA
TCGGATAGCCCCGAACTGA -> CGGATAGCCCCGAACTGAT
TGGGATACAGGGTGTGGGA -> GGGATACAGGGTGTGGGAT
AGCAATCGACATGCACGCA -> GCAATCGACATGCACGCAT
CATCGAGGCTGCAACGTCA -> ATCGAGGCTGCAACGTCAT
ATGCGGGTTCCAAAAGGCT -> TGCGGGTTCCAAAAGGCTC
TCGTAGGAATAGTGATTAG -> CGTAGGAATAGTGATTAGT
CCCCCCTTCCGGTCGGCCC -> CCCCCTTCCGGTCGGCCCT
GGGCCTGGATTATGTACCG -> GGCCTGGATTATGTACCGT
GGGAACACGGTTATTCTAC -> GGAACACGGTTATTCTACC
TTAGCAATCGACATGCACG -> TAGCAATCGACATGCACGC
AAGTCTCCGGAATATACGC -> AGTCTCCGGAATATACGCT
CCATCTCATGTCGATATTT -> CATCTCATGTCGATATTTC
GATGGCGCCATTATATAGC -> ATGGCGCCATTATATAGCA
CAATGATGAGTGTTGCCTC -> AATGATGAGTGTTGCCTCC
TTGGGAACACCTTTTTTCG -> TGGGAACACCTTTTTTCGA
CTGCGCGTCATGGACGTGG -> TGCGCGTCATGGACGTGGA
ATAACCACGTCCCCACAGC -> TAACCACGTCCCCACAGCA
TGCGCATAACGAGGGTTCC -> GCGCATAACGAGGGTTCCT
GGCATCGAGGCTGCAACGT -> GCATCGAGGCTGCAACGTC
AGAATGGTCCGCCGCAGGC -> GAATGGTCCGCCGCAGGCG
CGTAACGAATTTGATGTTA -> GTAACGAATTTGATGTTAC
TGGTTTTTCTATAATGATT -> GGTTTTTCTATAATGATTG
TAGCTTACATAGTGTCAGG -> AGCTTACATAGTGTCAGGT
TGGGTACAAGAGGTTGCGT -> GGGTACAAGAGGTTGCGTC
GAGCTCCATGAGCAAATTA -> AGCTCCATGAGCAAATTAG
GTTAGTTTGCAGTATCAGA -> TTAGTTTGCAGTATCAGAC
GATTGCCGCAAAGAGGGCT -> ATTGCCGCAAAGAGGGCTC
AAGGTCGGGTAACGTCTTG -> AGGTCGGGTAACGTCTTGT
GCCAGGTGGAACTCATTAA -> CCAGGTGGAACTCATTAAC
ATCAGCTATGATCTGAGAC -> TCAGCTATGATCTGAGACT
TAGTTAGTTTGCAGTATCA -> AGTTAGTTTGCAGTATCAG
TAAAGACCGGGTGTGTATG -> AAAGACCGGGTGTGTATGG
GACCGGGTGTGTATGGTTC -> ACCGGGTGTGTATGGTTCA
TGCAACGTCATATTCGCTG -> GCAACGTCATATTCGCTGC
CATAAAGTCGCCCACGGCC -> ATAAAGTCGCCCACGGCCA
TATAAGCAGCGAGGACACC -> ATAAGCAGCGAGGACACCG
ATGTATCAAGTGGCCCCTC -> TGTATCAAGTGGCCCCTCA
GAACTGATTAGAATACTGT -> AACTGATTAGAATACTGTA
CGGATCGACGCATGAGATA -> GGATCGACGCATGAGATAT
AGAAGATGGCGCCATTATA -> GAAGATGGCGCCATTATAT
TCAGCGCACTTTGTGGGCC -> CAGCGCACTTTGTGGGCCT
CACGATAATTCGGGTAAAT -> ACGATAATTCGGGTAAATC
CACCATCTACCCCTGATAT -> ACCATCTACCCCTGATATT
CGATGCGCGGTAGTGACGA -> GATGCGCGGTAGTGACGAA
CACGGATCGACGCATGAGA -> ACGGATCGACGCATGAGAT
AGAAAAATTGATAAATTGG -> GAAAAATTGATAAATTGGG
TCCGCCGCAGGCGATGACG -> CCGCCGCAGGCGATGACGG
CATGAGATATAAGCAGCGA -> ATGAGATATAAGCAGCGAG
CTGGAAATCCGTGAGCAAG -> TGGAAATCCGTGAGCAAGA
CATACAGGGTCATAAGAGC -> ATACAGGGTCATAAGAGCG
GATAACCACGTCCCCACAG -> ATAACCACGTCCCCACAGC
TATCATTAGCAATCGACAT -> ATCATTAGCAATCGACATG
GATGGTTGGCTACGCTTCG -> ATGGTTGGCTACGCTTCGC
AAGAATCATAAAGTCGCAC -> AGAATCATAAAGTCGCACC
ACAGTGTAGTGGAATCCGG -> CAGTGTAGTGGAATCCGGC
CAATTTACGGTATGTGAGT -> AATTTACGGTATGTGAGTC
CCATGACTAAGTCGTTCGC -> CATGACTAAGTCGTTCGCA
CTCATACTCGACAGATCAC -> TCATACTCGACAGATCACT
GGATTAGAGGTGGATGCTG -> GATTAGAGGTGGATGCTGT
TAGCATCACACCGCATCTT -> AGCATCACACCGCATCTTG
GTAGCACGTAGCGTTCTAA -> TAGCACGTAGCGTTCTAAT
TGAGACTAAACGCGAACGA -> GAGACTAAACGCGAACGAC
GGTCCGTGTAAACACATGC -> GTCCGTGTAAACACATGCA
TATGTACCGTAACGAATTC -> ATGTACCGTAACGAATTCG
TACTGTATTAATATAATGT -> ACTGTATTAATATAATGTG
ATATTCGCTGCAATGTGCG -> TATTCGCTGCAATGTGCGC
CATGTAGCTATAGGAAGGT -> ATGTAGCTATAGGAAGGTC
CCCATGACTAAGTCGTTCG -> CCATGACTAAGTCGTTCGC
TTTATAGGCTGTGCCCGCA -> TTATAGGCTGTGCCCGCAC
CGCACGTAAAGAAGATGGC -> GCACGTAAAGAAGATGGCG
AGCTCTATAGACATTAGGA -> GCTCTATAGACATTAGGAT
GCTATGATCTGAGACTAAA -> CTATGATCTGAGACTAAAC
ATGTACCGTAACGAATTTG -> TGTACCGTAACGAATTTGA
TAACGTCTTGTTGGGATAC -> AACGTCTTGTTGGGATACA
ACCCCCCCCTTCCGGTCGG -> CCCCCCCCTTCCGGTCGGC
TGGAAATCCGTGAGCAAGA -> GGAAATCCGTGAGCAAGAA
GCGTCAAGGACCGCGTCCG -> CGTCAAGGACCGCGTCCGC
TGTCGATATTTCCGGTGAT -> GTCGATATTTCCGGTGATC
GGATACAGGGTGTGGGATT -> GATACAGGGTGTGGGATTA
CTGGGTAGCCCCTTCGCTT -> TGGGTAGCCCCTTCGCTTA
TCGATTCCACCACCGTTAA -> CGATTCCACCACCGTTAAT
TACCGTAACGAATCCCAAG -> ACCGTAACGAATCCCAAGG
AAGAAGATGGCGCCATTAT -> AGAAGATGGCGCCATTATA
GGGGATTAGCTTACATAGT -> GGGATTAGCTTACATAGTG
TCTGCCAGCTCACTTCTCT -> CTGCCAGCTCACTTCTCTC
GTACCGTAACGAATTCGGC -> TACCGTAACGAATTCGGCA
TATCCCTCGCCGAAATTGT -> ATCCCTCGCCGAAATTGTC
CCCCCCCTTCCGGTCGGCC -> CCCCCCTTCCGGTCGGCCC
GTGATCCAGAAAGATGGTT -> TGATCCAGAAAGATGGTTG
GGACCGTATTATGTACCGT -> GACCGTATTATGTACCGTA
GACAGTGTAGTGGAATCCG -> ACAGTGTAGTGGAATCCGG
CCACCACCGTTAATTAGGA -> CACCACCGTTAATTAGGAG
GACTGCCGTTGTGACTTTC -> ACTGCCGTTGTGACTTTCT
CAAAAGGCTCGTCCCGCTC -> AAAAGGCTCGTCCCGCTCC
GTCGGATAGCCCCGAACTG -> TCGGATAGCCCCGAACTGA
AACGGCCTCAGCCCCGAGC -> ACGGCCTCAGCCCCGAGCC
CTCTAGACAAGTCGGCGTC -> TCTAGACAAGTCGGCGTCA
GATGCTGTTTTAGAGCCGG -> ATGCTGTTTTAGAGCCGGA
TCCGCGCCCATGACTAAGT -> CCGCGCCCATGACTAAGTC
CTATCAACCTTAAGCGGGG -> TATCAACCTTAAGCGGGGT
GAGCCGGAAGGACCAAGAA -> AGCCGGAAGGACCAAGAAT
GGGATACAGGGTGTGGGAT -> GGATACAGGGTGTGGGATT
TTCGCTGCAATGTGCGCAT -> TCGCTGCAATGTGCGCATA
CTACACACGTTTATACAAG -> TACACACGTTTATACAAGA
TAGGATGGGCCGGATTCGT -> AGGATGGGCCGGATTCGTT
TCCCGTAGAATGGTCCGCC -> CCCGTAGAATGGTCCGCCG
CGGTGATCCAGAAAGATGG -> GGTGATCCAGAAAGATGGT
TGCCGCAAAGAGGGCTCAG -> GCCGCAAAGAGGGCTCAGG
CGCGATCCCGTAGAATGGT -> GCGATCCCGTAGAATGGTC
CTGAGACTAAACGCGAACG -> TGAGACTAAACGCGAACGA
ATTAGAGGTGGATGCTGTT -> TTAGAGGTGGATGCTGTTT
TGATCACCCGTCGCAATTT -> GATCACCCGTCGCAATTTA
CGTCATGGACGTGGAGGAT -> GTCATGGACGTGGAGGATG
TTCGATTCCACCACCGTTA -> TCGATTCCACCACCGTTAA
AATGATTGCCGCAAAGAGG -> ATGATTGCCGCAAAGAGGG
CCCTTAACTTATGAGAGTG -> CCTTAACTTATGAGAGTGG
ATTCTGCGTATCAGACAAC -> TTCTGCGTATCAGACAACT
TATCAAGTGGCCCCTCAGT -> ATCAAGTGGCCCCTCAGTA
GGTCACCACGATAATTCGG -> GTCACCACGATAATTCGGG
CCTTCCGGTCGGCCCTTCA -> CTTCCGGTCGGCCCTTCAG
CGTTCGCAGAGATAACCAC -> GTTCGCAGAGATAACCACG
GAAGAAGGTCAAAGTCTCC -> AAGAAGGTCAAAGTCTCCG
TCTACCCCTGATATTGTAC -> CTACCCCTGATATTGTACC
GGGGAACACGGTTATTCTA -> GGGAACACGGTTATTCTAC
TAAACGCGAACGACAGTGT -> AAACGCGAACGACAGTGTA
TAGAGCCGGAAGGACCAAG -> AGAGCCGGAAGGACCAAGA
AACTTATGAGAGTGGTATC -> ACTTATGAGAGTGGTATCT
GGACACCCTTAACTTATGA -> GACACCCTTAACTTATGAG
AATCCGTGAGCAAGAATCA -> ATCCGTGAGCAAGAATCAT
CAGGAATCTGCCAGCTCAC -> AGGAATCTGCCAGCTCACT
CAATCGACATGCACGCATA -> AATCGACATGCACGCATAC
CACTCTGGAAATCCGTGAG -> ACTCTGGAAATCCGTGAGC
GTGTGTATGGTTCAGGAAG -> TGTGTATGGTTCAGGAAGA
ATCTCATGTCGATATTTCC -> TCTCATGTCGATATTTCCG
ATACAAGAATCATAAAGTC -> TACAAGAATCATAAAGTCG
AAATCGGGGAACACGGTTA -> AATCGGGGAACACGGTTAT
ACCGTAACGAATAAAGACC -> CCGTAACGAATAAAGACCG
TTCTCTCTCGCCCGGGGAT -> TCTCTCTCGCCCGGGGATT
CGAATTATGATAGTCGGAT -> GAATTATGATAGTCGGATA
AGGACCGCGTCCGCGAGAC -> GGACCGCGTCCGCGAGACT
ATCATGCGGGTTCCAAAAG -> TCATGCGGGTTCCAAAAGG
TTATGTATCAAGTGGCCCC -> TATGTATCAAGTGGCCCCT
ATATAAGCAGCGAGGACAC -> TATAAGCAGCGAGGACACC
AAGATGGTTGGCTACGCTT -> AGATGGTTGGCTACGCTTC
TTACTTACCGGTCGTATAC -> TACTTACCGGTCGTATACT
TCCACAAGTCATCATGTAA -> CCACAAGTCATCATGTAAG
TAATGATTGCCGCAAAGAG -> AATGATTGCCGCAAAGAGG
GAGGCTGCAACGTCATATT -> AGGCTGCAACGTCATATTC
ACTCAGCGCACTTTGTGGG -> CTCAGCGCACTTTGTGGGC
CCATCTACCCCTGATATTG -> CATCTACCCCTGATATTGT
AAAGACCGGGTGTGTATGG -> AAGACCGGGTGTGTATGGT
CGTCCGCGAGACTGCCGTT -> GTCCGCGAGACTGCCGTTG
GGGATTAGAGGTGGATGCT -> GGATTAGAGGTGGATGCTG
ACGTGGAGGATGACGGCTT -> CGTGGAGGATGACGGCTTA
GTAGCTATAGGAAGGTCTA -> TAGCTATAGGAAGGTCTAT
ATAGCCCCGAACTGATTAG -> TAGCCCCGAACTGATTAGA
ATAGACATTAGGATGGGCC -> TAGACATTAGGATGGGCCG
GTCATCATGTAAGATGGAA -> TCATCATGTAAGATGGAAG
CACATGCACCCCCCCCTTC -> ACATGCACCCCCCCCTTCC
TATGGACTTCTTAAGGTCG -> ATGGACTTCTTAAGGTCGG
CGGTAGTGACGAAGGAGTA -> GGTAGTGACGAAGGAGTAT
GCCCCGAACTGATTAGAAT -> CCCCGAACTGATTAGAATA
TAACGAATAAAGACCGGGT -> AACGAATAAAGACCGGGTG
AGGTGGAACTCATTAACAA -> GGTGGAACTCATTAACAAT
AACTGATTAGAATACTGTA -> ACTGATTAGAATACTGTAT
TGAGTGTTGCCTCCACAAG -> GAGTGTTGCCTCCACAAGT
ATGCACCCCCCCCTTCCGG -> TGCACCCCCCCCTTCCGGT
TGGCTTAATCTCTGGTGTG -> GGCTTAATCTCTGGTGTGC
CTGCCCGCAAAAGCCCTCA -> TGCCCGCAAAAGCCCTCAT
CCCGTCGCAATTTACGGTA -> CCGTCGCAATTTACGGTAT
TTTTAGAGCCGGAAGGACC -> TTTAGAGCCGGAAGGACCA
TGTGTATGGTTCAGGAAGA -> GTGTATGGTTCAGGAAGAA
TCAGCTCTATAGACATTAG -> CAGCTCTATAGACATTAGG
CGTCGCAATTTACGGTATG -> GTCGCAATTTACGGTATGT
GCGCATAACGAGGGTTCCT -> CGCATAACGAGGGTTCCTG
TGCAGTATCAGACTCTGTA -> GCAGTATCAGACTCTGTAG
AAGTCGTTCGCAGAGATAA -> AGTCGTTCGCAGAGATAAC
TCTTAAATCGGGGAACACG -> CTTAAATCGGGGAACACGG
CGCACACTGCGCGTCATGG -> GCACACTGCGCGTCATGGA
GCAAAAGCCCTCATGAACA -> CAAAAGCCCTCATGAACAG
GATACAGGGTGTGGGATTA -> ATACAGGGTGTGGGATTAG
TAACAATGATGAGTGTTGC -> AACAATGATGAGTGTTGCC
TTCCAAAAGGCTCGTCCCG -> TCCAAAAGGCTCGTCCCGC
ATCGATCGCACGTAAAGAA -> TCGATCGCACGTAAAGAAG
CAGTCTGATCGGGTTATCA -> AGTCTGATCGGGTTATCAT
GAATTATGTACCGTAACGA -> AATTATGTACCGTAACGAA
CGCCCGGGGATTAGCTTAC -> GCCCGGGGATTAGCTTACA
GTGGCTTAATCTCTGGTGT -> TGGCTTAATCTCTGGTGTG
GACCGTATTATGTACCGTA -> ACCGTATTATGTACCGTAA
ACGGATCCGCGCCCATGAC -> CGGATCCGCGCCCATGACT
CAAGGACCGCGTCCGCGAG -> AAGGACCGCGTCCGCGAGA
GGGTTCCTGTTGCTTAAGA -> GGTTCCTGTTGCTTAAGAA
TTAGGTTGGAATAGTTAGT -> TAGGTTGGAATAGTTAGTT
TCGATGCGCGGTAGTGACG -> CGATGCGCGGTAGTGACGA
AATCATAAAGTCGCGCCGT -> ATCATAAAGTCGCGCCGTC
TGACGAAGGAGTATATAAC -> GACGAAGGAGTATATAACA
GTCGCGCCGTCCCCGAATT -> TCGCGCCGTCCCCGAATTA
CTGATGAGAAAAATTGATA -> TGATGAGAAAAATTGATAA
TGCGCGTCATGGACGTGGA -> GCGCGTCATGGACGTGGAG
TGCACCCCCCCCTTCCGGT -> GCACCCCCCCCTTCCGGTC
CTTAAGGTCGGGTAACGTC -> TTAAGGTCGGGTAACGTCT
TATTCCCCTGTCGATCAGC -> ATTCCCCTGTCGATCAGCT
CCGGTCGTATACTAACGAA -> CGGTCGTATACTAACGAAC
GTGTGATGGTTTTTCTATA -> TGTGATGGTTTTTCTATAA
CAATGTGCGCATAACGAGG -> AATGTGCGCATAACGAGGG
ACTAGTCAAGAATCATAAA -> CTAGTCAAGAATCATAAAG
GCAATCGACATGCACGCAT -> CAATCGACATGCACGCATA
TTACGGTATGTGAGTCCTA -> TACGGTATGTGAGTCCTAC
TCATGAACAGCTACCTATC -> CATGAACAGCTACCTATCC
AACAGCTACCTATCCCTCG -> ACAGCTACCTATCCCTCGC
CAAAGTCTCCGGAATATAC -> AAAGTCTCCGGAATATACG
TCCCGCTCCTGTGTGAAGC -> CCCGCTCCTGTGTGAAGCG
GGACAGAATACGCGATCCC -> GACAGAATACGCGATCCCG
TATATGGTCACCACGATAA -> ATATGGTCACCACGATAAT
GACGGATAAGTTTTCGATT -> ACGGATAAGTTTTCGATTC
AGCCCCGAGCCATTCTGTA -> GCCCCGAGCCATTCTGTAT
CCCCCTTCCGGTCGGCCCT -> CCCCTTCCGGTCGGCCCTT
AAAGCCCTCATGAACAGCT -> AAGCCCTCATGAACAGCTA
ATAAAGTCGCCCACGGCCA -> TAAAGTCGCCCACGGCCAG
CTAGAAGGTCCCCACTCTG -> TAGAAGGTCCCCACTCTGG
AGGCTAGGGTGGCCATCTC -> GGCTAGGGTGGCCATCTCA
CGTTAATTAGGAGCCAACG -> GTTAATTAGGAGCCAACGG
TAGGACCGTATTATGTACC -> AGGACCGTATTATGTACCG
AGGTTGGAATAGTTAGTTT -> GGTTGGAATAGTTAGTTTG
AAGCAGCGAGGACACCGTT -> AGCAGCGAGGACACCGTTC
CGTAAAGAAGATGGCGCCA -> GTAAAGAAGATGGCGCCAT
CCCGAGCCATTCTGTATAG -> CCGAGCCATTCTGTATAGA
GAATAGTTAGTTTGCAGTA -> AATAGTTAGTTTGCAGTAT
CTCTTAAATCGGGGAACAC -> TCTTAAATCGGGGAACACG
GAGAGTGGTATCTGCCCGC -> AGAGTGGTATCTGCCCGCA
AAGTCGCGCCGTCCCCGAA -> AGTCGCGCCGTCCCCGAAT
AACTATCAACCTTAAGCGG -> ACTATCAACCTTAAGCGGG
TAACGAATTCGGCATCGAG -> AACGAATTCGGCATCGAGG
CGATCGCACGTAAAGAAGA -> GATCGCACGTAAAGAAGAT
CCCCTTCGCTTAGGTTGGA -> CCCTTCGCTTAGGTTGGAA
TTTGTGGGCCTGTTTATAG -> TTGTGGGCCTGTTTATAGG
AGCGCACTTTGTGGGCCTG -> GCGCACTTTGTGGGCCTGT
TAACTTATGAGAGTGGTAT -> AACTTATGAGAGTGGTATC
TCCCTCGCCGAAATTGTCC -> CCCTCGCCGAAATTGTCCA
GTAGGACATACGGACAGAA -> TAGGACATACGGACAGAAT
CTGATCACCCGTCGCAATT -> TGATCACCCGTCGCAATTT
CGCGAACGACAGTGTAGTG -> GCGAACGACAGTGTAGTGG
ATTAATATAATGTGGCTTA -> TTAATATAATGTGGCTTAA
GATGAGTGTTGCCTCCACA -> ATGAGTGTTGCCTCCACAA
TATTCGCTGCAATGTGCGC -> ATTCGCTGCAATGTGCGCA
TATAGCATCACACCGCATC -> ATAGCATCACACCGCATCT
TGATTAGAATACTGTATTA -> GATTAGAATACTGTATTAA
GTAGAATGGTCCGCCGCAG -> TAGAATGGTCCGCCGCAGG
ACTAAACGCGAACGACAGT -> CTAAACGCGAACGACAGTG
GGCCATCTCATGTCGATAT -> GCCATCTCATGTCGATATT
CTCGCCGAAATTGTCCATA -> TCGCCGAAATTGTCCATAC
ATGGTCCGCCGCAGGCGAT -> TGGTCCGCCGCAGGCGATG
GGGCCGGATTCGTTAACTC -> GGCCGGATTCGTTAACTCA
GCCGCAAAGAGGGCTCAGG -> CCGCAAAGAGGGCTCAGGC
CAAAGAGGGCTCAGGCGTT -> AAAGAGGGCTCAGGCGTTA
AGTCGCACCGGGCCTGGAT -> GTCGCACCGGGCCTGGATT
TTGGGATACAGGGTGTGGG -> TGGGATACAGGGTGTGGGA
GCCCATGACTAAGTCGTTC -> CCCATGACTAAGTCGTTCG
CGGTTATTCTACCATTGAG -> GGTTATTCTACCATTGAGC
ATCCGAATTATGATAGTCG -> TCCGAATTATGATAGTCGG
AAATCCGTGAGCAAGAATC -> AATCCGTGAGCAAGAATCA
CTTAAATCGGGGAACACGG -> TTAAATCGGGGAACACGGT
GTATCAGACAACTCCAGGC -> TATCAGACAACTCCAGGCA
CTACGCTTCGCTCATACTC -> TACGCTTCGCTCATACTCG
TTAGGAGCCAACGGCCTCA -> TAGGAGCCAACGGCCTCAG
GATGAGAAAAATTGATAAA -> ATGAGAAAAATTGATAAAT
TGCGTTTTTCCAATGCAAA -> GCGTTTTTCCAATGCAAAT
TGCGTCAAGGACCGCGTCC -> GCGTCAAGGACCGCGTCCG
CGACAGTGTAGTGGAATCC -> GACAGTGTAGTGGAATCCG
TCGGCATCGAGGCTGCAAC -> CGGCATCGAGGCTGCAACG
GGTCAAAGTCTCCGGAATA -> GTCAAAGTCTCCGGAATAT
GTCGAATTAATTACCGTGG -> TCGAATTAATTACCGTGGG
GAATCCGGCGTACTGATCA -> AATCCGGCGTACTGATCAC
TACCGTAACGAATTTGATG -> ACCGTAACGAATTTGATGT
GCACTTTGTGGGCCTGTTT -> CACTTTGTGGGCCTGTTTA
CCTGTGTGAAGCGTGTGAT -> CTGTGTGAAGCGTGTGATG
CCGCAAAGAGGGCTCAGGC -> CGCAAAGAGGGCTCAGGCG
CCGTTGTGACTTTCTTTAC -> CGTTGTGACTTTCTTTACA
AATCCGAATTATGATAGTC -> ATCCGAATTATGATAGTCG
GTAGTGACGAAGGAGTATA -> TAGTGACGAAGGAGTATAT
TCTTGTTGGGATACAGGGT -> CTTGTTGGGATACAGGGTG
CCCACTCTGGAAATCCGTG -> CCACTCTGGAAATCCGTGA
AACGAATCCCAAGGCTAGG -> ACGAATCCCAAGGCTAGGG
TAACTCAGCGCACTTTGTG -> AACTCAGCGCACTTTGTGG
ACCTATCCCTCGCCGAAAT -> CCTATCCCTCGCCGAAATT
CCGTAACGAATAAAGACCG -> CGTAACGAATAAAGACCGG
AGCCCCGAACTGATTAGAA -> GCCCCGAACTGATTAGAAT
ACCACGTCCCCACAGCATC -> CCACGTCCCCACAGCATCG
GTCGTATACTAACGAACTA -> TCGTATACTAACGAACTAT
TGTTTATAGGCTGTGCCCG -> GTTTATAGGCTGTGCCCGC
GTTATGTATCAAGTGGCCC -> TTATGTATCAAGTGGCCCC
AATGATGAGTGTTGCCTCC -> ATGATGAGTGTTGCCTCCA
GGCCTGGATTATGTACCGT -> GCCTGGATTATGTACCGTA
TTGATGTTACTCTAGACAA -> TGATGTTACTCTAGACAAG
GCCCCTCAGTAGGACATAC -> CCCCTCAGTAGGACATACG
ATACAGGGTCATAAGAGCG -> TACAGGGTCATAAGAGCGA
TCCGGCGTACTGATCACCC -> CCGGCGTACTGATCACCCG
CAGAGATAACCACGTCCCC -> AGAGATAACCACGTCCCCA
GCCTCCACAAGTCATCATG -> CCTCCACAAGTCATCATGT
TAAGCGGGGTTTGAGTCAC -> AAGCGGGGTTTGAGTCACT
CGGTATGTGAGTCCTACAC -> GGTATGTGAGTCCTACACA
CCCTCAGTAGGACATACGG -> CCTCAGTAGGACATACGGA
CAGCTACCTATCCCTCGCC -> AGCTACCTATCCCTCGCCG
AAGAGGGCTCAGGCGTTAC -> AGAGGGCTCAGGCGTTACT
ATGAGATATAAGCAGCGAG -> TGAGATATAAGCAGCGAGG
ACCTCAATCCGAATTATGA -> CCTCAATCCGAATTATGAT
ATCTTGCTAGAGCCAGGTG -> TCTTGCTAGAGCCAGGTGG
ATGAGAAAAATTGATAAAT -> TGAGAAAAATTGATAAATT
GCTTCTCGCTTAGTTATCG -> CTTCTCGCTTAGTTATCGA
AGGACCAAGAATCATAAAG -> GGACCAAGAATCATAAAGT
TTATAGCACGGATCGACGC -> TATAGCACGGATCGACGCA
GCATCGATCGCACGTAAAG -> CATCGATCGCACGTAAAGA
GAGTCACTCTTTTATTCCC -> AGTCACTCTTTTATTCCCC
TAACCTAGAAGGTCCCCAC -> AACCTAGAAGGTCCCCACT
GCCGGAAGGACCAAGAATC -> CCGGAAGGACCAAGAATCA
CCTTCGCTTAGGTTGGAAT -> CTTCGCTTAGGTTGGAATA
AGAGATAACCACGTCCCCA -> GAGATAACCACGTCCCCAC
CACTGGAGGTTATGTATCA -> ACTGGAGGTTATGTATCAA
ACCGTCTCGTAGGAATAGT -> CCGTCTCGTAGGAATAGTG
CAGTAGGACATACGGACAG -> AGTAGGACATACGGACAGA
GTGAGCAAGAATCATAAAG -> TGAGCAAGAATCATAAAGT
CCAATGCAAATGCAGGAAT -> CAATGCAAATGCAGGAATC
AACCACGTCCCCACAGCAT -> ACCACGTCCCCACAGCATC
GTTCCAAAAGGCTCGTCCC -> TTCCAAAAGGCTCGTCCCG
AACCTAGAAGGTCCCCACT -> ACCTAGAAGGTCCCCACTC
CCATACTCCGTTACCCGAG -> CATACTCCGTTACCCGAGT
TATTCTACCATTGAGCTCC -> ATTCTACCATTGAGCTCCA
CCGGAATATACGCTTCTCG -> CGGAATATACGCTTCTCGC
CTCTCGCCCGGGGATTAGC -> TCTCGCCCGGGGATTAGCT
CAGACAACTCCAGGCATGT -> AGACAACTCCAGGCATGTA
TTTCCAATGCAAATGCAGG -> TTCCAATGCAAATGCAGGA
CAGGAAGAAGGTCAAAGTC -> AGGAAGAAGGTCAAAGTCT
TCACTCTTTTATTCCCCTG -> CACTCTTTTATTCCCCTGT
GGACGTGGAGGATGACGGC -> GACGTGGAGGATGACGGCT
TGGAGGTTATGTATCAAGT -> GGAGGTTATGTATCAAGTG
GGAGGATGACGGCTTAGTT -> GAGGATGACGGCTTAGTTG
TGCGTATCAGACAACTCCA -> GCGTATCAGACAACTCCAG
TCCAGAAAGATGGTTGGCT -> CCAGAAAGATGGTTGGCTA
AATATAATGTGGCTTAATC -> ATATAATGTGGCTTAATCT
TCGGCGTCAGCTCTATAGA -> CGGCGTCAGCTCTATAGAC
TTAATCTCTGGTGTGCGTT -> TAATCTCTGGTGTGCGTTT
GTGATTAGTATACACCATC -> TGATTAGTATACACCATCT
GGAAGAAGGTCAAAGTCTC -> GAAGAAGGTCAAAGTCTCC
CCCGAATTATGTACCGTAA -> CCGAATTATGTACCGTAAC
GACAGAATACGCGATCCCG -> ACAGAATACGCGATCCCGT
CGGCCCTTCAGCTCTCTTA -> GGCCCTTCAGCTCTCTTAA
TGCAATGTGCGCATAACGA -> GCAATGTGCGCATAACGAG
AGCTCACTTCTCTCTCGCC -> GCTCACTTCTCTCTCGCCC
TCTATAGACATTAGGATGG -> CTATAGACATTAGGATGGG
GGGAACACCTTTTTTCGAT -> GGAACACCTTTTTTCGATC
CATACGGACAGAATACGCG -> ATACGGACAGAATACGCGA
GATCAGCTATGATCTGAGA -> ATCAGCTATGATCTGAGAC
ACGCATGAGATATAAGCAG -> CGCATGAGATATAAGCAGC
GATTCGTTAACTCAGCGCA -> ATTCGTTAACTCAGCGCAC
TCCACCACCGTTAATTAGG -> CCACCACCGTTAATTAGGA
CAAATGCAGGAATCTGCCA -> AAATGCAGGAATCTGCCAG
GGTCCGCCGCAGGCGATGA -> GTCCGCCGCAGGCGATGAC
ATCTCTGGTGTGCGTTTTT -> TCTCTGGTGTGCGTTTTTC
TACCTATCCCTCGCCGAAA -> ACCTATCCCTCGCCGAAAT
CACCGTTCACTGGAGGTTA -> ACCGTTCACTGGAGGTTAT
AAAGATGGTTGGCTACGCT -> AAGATGGTTGGCTACGCTT
GCTTAAGAACAGTCTGATC -> CTTAAGAACAGTCTGATCG
TATCAGACAACTCCAGGCA -> ATCAGACAACTCCAGGCAT
TACCCGAGTAACCTAGAAG -> ACCCGAGTAACCTAGAAGG
TAGTTATCGATGCGCGGTA -> AGTTATCGATGCGCGGTAG
TCGGCCCTTCAGCTCTCTT -> CGGCCCTTCAGCTCTCTTA
GCGCGTCATGGACGTGGAG -> CGCGTCATGGACGTGGAGG
CGGCGTCAGCTCTATAGAC -> GGCGTCAGCTCTATAGACA
CCGGGTGTGTATGGTTCAG -> CGGGTGTGTATGGTTCAGG
GAGGTGGATGCTGTTTTAG -> AGGTGGATGCTGTTTTAGA
AAGTCGGCGTCAGCTCTAT -> AGTCGGCGTCAGCTCTATA
CCACAAGTCATCATGTAAG -> CACAAGTCATCATGTAAGA
GCGCACTTTGTGGGCCTGT -> CGCACTTTGTGGGCCTGTT
GCAGAGATAACCACGTCCC -> CAGAGATAACCACGTCCCC
ATGCAAATGCAGGAATCTG -> TGCAAATGCAGGAATCTGC
GAGTAACCTAGAAGGTCCC -> AGTAACCTAGAAGGTCCCC
TCTACCATTGAGCTCCATG -> CTACCATTGAGCTCCATGA
GAACGACAGTGTAGTGGAA -> AACGACAGTGTAGTGGAAT
CCGGATTCGTTAACTCAGC -> CGGATTCGTTAACTCAGCG
GTACAAGAGGTTGCGTCAA -> TACAAGAGGTTGCGTCAAG
GCATTCTGCGTATCAGACA -> CATTCTGCGTATCAGACAA
TATATAGCAACCAACTTCT -> ATATAGCAACCAACTTCTG
ATTTCCGGTGATCCAGAAA -> TTTCCGGTGATCCAGAAAG
TACTGATCACCCGTCGCAA -> ACTGATCACCCGTCGCAAT
GTAGCGTTCTAATCAATCA -> TAGCGTTCTAATCAATCAA
TGGTGTGCGTTTTTCCAAT -> GGTGTGCGTTTTTCCAATG
AGCAAGAATCATAAAGTCG -> GCAAGAATCATAAAGTCGC
TGCACGCATACAGGGTCAT -> GCACGCATACAGGGTCATA
GGTAAATCATGCGGGTTCC -> GTAAATCATGCGGGTTCCA
CCCCTTCCGGTCGGCCCTT -> CCCTTCCGGTCGGCCCTTC
GCATCACACCGCATCTTGC -> CATCACACCGCATCTTGCT
TATGGCATTCTGCGTATCA -> ATGGCATTCTGCGTATCAG
CAGGGTCATAAGAGCGAGA -> AGGGTCATAAGAGCGAGAC
CCTATCCCTCGCCGAAATT -> CTATCCCTCGCCGAAATTG
AAGAGCGAGACTAGTCAAG -> AGAGCGAGACTAGTCAAGA
GCAAGAATCATAAAGTCGC -> CAAGAATCATAAAGTCGCG
AATTAGGAGCCAACGGCCT -> ATTAGGAGCCAACGGCCTC
TGGACTTCTTAAGGTCGGG -> GGACTTCTTAAGGTCGGGT
AAAGAAGATGGCGCCATTA -> AAGAAGATGGCGCCATTAT
TAGGTTGGAATAGTTAGTT -> AGGTTGGAATAGTTAGTTT
CTTCTCTCTCGCCCGGGGA -> TTCTCTCTCGCCCGGGGAT
GTATGGTTCAGGAAGAAGG -> TATGGTTCAGGAAGAAGGT
AAATTAGCCTGATTATAGC -> AATTAGCCTGATTATAGCA
TGCTTAAGAACAGTCTGAT -> GCTTAAGAACAGTCTGATC
TGAGCTCCATGAGCAAATT -> GAGCTCCATGAGCAAATTA
TGTTACTCTAGACAAGTCG -> GTTACTCTAGACAAGTCGG
ATTTGATGTTACTCTAGAC -> TTTGATGTTACTCTAGACA
TATAGACATTAGGATGGGC -> ATAGACATTAGGATGGGCC
CACCTTTTTTCGATCTAGA -> ACCTTTTTTCGATCTAGAA
CCATGAGCAAATTAGCCTG -> CATGAGCAAATTAGCCTGA
GAAGATGGCGCCATTATAT -> AAGATGGCGCCATTATATA
TCGCGCCGTCCCCGAATTA -> CGCGCCGTCCCCGAATTAT
CCCCTGTCGATCAGCTATG -> CCCTGTCGATCAGCTATGA
ACCACGATAATTCGGGTAA -> CCACGATAATTCGGGTAAA
ACAATGATGAGTGTTGCCT -> CAATGATGAGTGTTGCCTC
GGTGATCCAGAAAGATGGT -> GTGATCCAGAAAGATGGTT
GTTTTTCCAATGCAAATGC -> TTTTTCCAATGCAAATGCA
AACGTCATATTCGCTGCAA -> ACGTCATATTCGCTGCAAT
ACTGATCACCCGTCGCAAT -> CTGATCACCCGTCGCAATT
CACACCGCATCTTGCTAGA -> ACACCGCATCTTGCTAGAG
TTAGTTTGCAGTATCAGAC -> TAGTTTGCAGTATCAGACT
CAGCTCACTTCTCTCTCGC -> AGCTCACTTCTCTCTCGCC
ACGTCATATTCGCTGCAAT -> CGTCATATTCGCTGCAATG
CAGAAAGATGGTTGGCTAC -> AGAAAGATGGTTGGCTACG
TCAGGCGTTACTTACCGGT -> CAGGCGTTACTTACCGGTC
CCTTCAGCTCTCTTAAATC -> CTTCAGCTCTCTTAAATCG
CGTACTGATCACCCGTCGC -> GTACTGATCACCCGTCGCA
ATCAGACAACTCCAGGCAT -> TCAGACAACTCCAGGCATG
CTGCAACGTCATATTCGCT -> TGCAACGTCATATTCGCTG
AACTCCAGGCATGTAGCTA -> ACTCCAGGCATGTAGCTAT
CAATGCAAATGCAGGAATC -> AATGCAAATGCAGGAATCT
GTATTAATATAATGTGGCT -> TATTAATATAATGTGGCTT
GGAGCCAACGGCCTCAGCC -> GAGCCAACGGCCTCAGCCC
ATTATAGCACGGATCGACG -> TTATAGCACGGATCGACGC
TAAAGTCGCGCCGTCCCCG -> AAAGTCGCGCCGTCCCCGA
GGATTCGTTAACTCAGCGC -> GATTCGTTAACTCAGCGCA
AACTCATTAACAATGATGA -> ACTCATTAACAATGATGAG
GGTTGCGTCAAGGACCGCG -> GTTGCGTCAAGGACCGCGT
AGAGTGGTATCTGCCCGCA -> GAGTGGTATCTGCCCGCAA
TGATTAGTATACACCATCT -> GATTAGTATACACCATCTA
TGGATGCTGTTTTAGAGCC -> GGATGCTGTTTTAGAGCCG
TTCAGGAAGAAGGTCAAAG -> TCAGGAAGAAGGTCAAAGT
ACCGCGTCCGCGAGACTGC -> CCGCGTCCGCGAGACTGCC
GCACGCATACAGGGTCATA -> CACGCATACAGGGTCATAA
TTAGTTATCGATGCGCGGT -> TAGTTATCGATGCGCGGTA
CTCCACAAGTCATCATGTA -> TCCACAAGTCATCATGTAA
ATCATAAAGTCGCGCCGTC -> TCATAAAGTCGCGCCGTCC
GAATAAAGACCGGGTGTGT -> AATAAAGACCGGGTGTGTA
TCATAAAGTCGCACCGGGC -> CATAAAGTCGCACCGGGCC
TTCGCTTAGGTTGGAATAG -> TCGCTTAGGTTGGAATAGT
TTAGAGCCGGAAGGACCAA -> TAGAGCCGGAAGGACCAAG
TTGGCTACGCTTCGCTCAT -> TGGCTACGCTTCGCTCATA
CGCAAAGAGGGCTCAGGCG -> GCAAAGAGGGCTCAGGCGT
AGTCGGATAGCCCCGAACT -> GTCGGATAGCCCCGAACTG
GAGCCAGGTGGAACTCATT -> AGCCAGGTGGAACTCATTA
GTGGAATCCGGCGTACTGA -> TGGAATCCGGCGTACTGAT
CGTAACGAATAAAGACCGG -> GTAACGAATAAAGACCGGG
TCTAATCAATCAACGGATC -> CTAATCAATCAACGGATCC
GTAACGAATCCCAAGGCTA -> TAACGAATCCCAAGGCTAG
ATAATGTGACTCTGGGTAG -> TAATGTGACTCTGGGTAGC
ACTCCAGGCATGTAGCTAT -> CTCCAGGCATGTAGCTATA
AAGGTCAAAGTCTCCGGAA -> AGGTCAAAGTCTCCGGAAT
GAGGATGACGGCTTAGTTG -> AGGATGACGGCTTAGTTGA
CCGGGGATTAGCTTACATA -> CGGGGATTAGCTTACATAG
AAATTGATAAATTGGGAAC -> AATTGATAAATTGGGAACA
CCGAAATTGTCCATACTCC -> CGAAATTGTCCATACTCCG
ACAGATCACTCCGGACACC -> CAGATCACTCCGGACACCC
GTCGCAATTTACGGTATGT -> TCGCAATTTACGGTATGTG
CTGATCGGGTTATCATTAG -> TGATCGGGTTATCATTAGC
GGCTCGTCCCGCTCCTGTG -> GCTCGTCCCGCTCCTGTGT
ATAATGTGGCTTAATCTCT -> TAATGTGGCTTAATCTCTG
AAGAATCATAAAGTCGCCC -> AGAATCATAAAGTCGCCCA
ACTCTGGGTAGCCCCTTCG -> CTCTGGGTAGCCCCTTCGC
TTTATTCCCCTGTCGATCA -> TTATTCCCCTGTCGATCAG
GGTGGCCATCTCATGTCGA -> GTGGCCATCTCATGTCGAT
AAACACATGCACCCCCCCC -> AACACATGCACCCCCCCCT
TCCCCGAATTATGTACCGT -> CCCCGAATTATGTACCGTA
AAGGCTAGGGTGGCCATCT -> AGGCTAGGGTGGCCATCTC
CACTTCTCTCTCGCCCGGG -> ACTTCTCTCTCGCCCGGGG
AGTGATTAGTATACACCAT -> GTGATTAGTATACACCATC
AACATGTATATGGCATTCT -> ACATGTATATGGCATTCTG
CATAAAGTCGCGCCGTCCC -> ATAAAGTCGCGCCGTCCCC
AGTAGGACATACGGACAGA -> GTAGGACATACGGACAGAA
GGTTCCTGTTGCTTAAGAA -> GTTCCTGTTGCTTAAGAAC
GTCCCCACAGCATCGATCG -> TCCCCACAGCATCGATCGC
GTTGGCTACGCTTCGCTCA -> TTGGCTACGCTTCGCTCAT
TCCGGTGATCCAGAAAGAT -> CCGGTGATCCAGAAAGATG
TTGAGCTCCATGAGCAAAT -> TGAGCTCCATGAGCAAATT
TAGTCAAGAATCATAAAGT -> AGTCAAGAATCATAAAGTC
GATATTTCCGGTGATCCAG -> ATATTTCCGGTGATCCAGA
TCGGGTTATCATTAGCAAT -> CGGGTTATCATTAGCAATC
TCCGTGAGCAAGAATCATA -> CCGTGAGCAAGAATCATAA
TCCATACTCCGTTACCCGA -> CCATACTCCGTTACCCGAG
AATCCGGCGTACTGATCAC -> ATCCGGCGTACTGATCACC
AACTCAGCGCACTTTGTGG -> ACTCAGCGCACTTTGTGGG
CCTGTTTATAGGCTGTGCC -> CTGTTTATAGGCTGTGCCC
GAAGGTCAAAGTCTCCGGA -> AAGGTCAAAGTCTCCGGAA
CCTCAGTAGGACATACGGA -> CTCAGTAGGACATACGGAC
GCGTTTTTCCAATGCAAAT -> CGTTTTTCCAATGCAAATG
GTAACGAATTCGGCATCGA -> TAACGAATTCGGCATCGAG
GCTTAATCTCTGGTGTGCG -> CTTAATCTCTGGTGTGCGT
CAGGCGTTACTTACCGGTC -> AGGCGTTACTTACCGGTCG
TCCAATGCAAATGCAGGAA -> CCAATGCAAATGCAGGAAT
GTGTGGGATTAGAGGTGGA -> TGTGGGATTAGAGGTGGAT
TCTGTATAGAGAACCGTCT -> CTGTATAGAGAACCGTCTC
GAGGGTTCCTGTTGCTTAA -> AGGGTTCCTGTTGCTTAAG
TGTATCAAGTGGCCCCTCA -> GTATCAAGTGGCCCCTCAG
CTAGACAAGTCGGCGTCAG -> TAGACAAGTCGGCGTCAGC
TTATTCTACCATTGAGCTC -> TATTCTACCATTGAGCTCC
TGGGCCGGATTCGTTAACT -> GGGCCGGATTCGTTAACTC
TGGACGTGGAGGATGACGG -> GGACGTGGAGGATGACGGC
TGTAGTGGAATCCGGCGTA -> GTAGTGGAATCCGGCGTAC
CTCCGGAATATACGCTTCT -> TCCGGAATATACGCTTCTC
CAACCAACTTCTGATGAGA -> AACCAACTTCTGATGAGAA
GGGTGTGTATGGTTCAGGA -> GGTGTGTATGGTTCAGGAA
AACGACAGTGTAGTGGAAT -> ACGACAGTGTAGTGGAATC
CGTGTAAACACATGCACCC -> GTGTAAACACATGCACCCC
TTGCCTCCACAAGTCATCA -> TGCCTCCACAAGTCATCAT
GTGTAAACACATGCACCCC -> TGTAAACACATGCACCCCC
ATAAGCAGCGAGGACACCG -> TAAGCAGCGAGGACACCGT
CGATAATTCGGGTAAATCA -> GATAATTCGGGTAAATCAT
GTCGGGTAACGTCTTGTTG -> TCGGGTAACGTCTTGTTGG
TAGACAAGTCGGCGTCAGC -> AGACAAGTCGGCGTCAGCT
AATTAGCCTGATTATAGCA -> ATTAGCCTGATTATAGCAC
CCTTTTTTCGATCTAGAAC -> CTTTTTTCGATCTAGAACC
TTACCGGTCGTATACTAAC -> TACCGGTCGTATACTAACG
CTTACCGGTCGTATACTAA -> TTACCGGTCGTATACTAAC
TCCCCACTCTGGAAATCCG -> CCCCACTCTGGAAATCCGT
TGGTTCAGGAAGAAGGTCA -> GGTTCAGGAAGAAGGTCAA
ATATGGTCACCACGATAAT -> TATGGTCACCACGATAATT
AGGCTGCAACGTCATATTC -> GGCTGCAACGTCATATTCG
ATAAGAGCGAGACTAGTCA -> TAAGAGCGAGACTAGTCAA
TCGCTCATACTCGACAGAT -> CGCTCATACTCGACAGATC
TGACTCTGGGTAGCCCCTT -> GACTCTGGGTAGCCCCTTC
AATCTCTGGTGTGCGTTTT -> ATCTCTGGTGTGCGTTTTT
GTCGATATTTCCGGTGATC -> TCGATATTTCCGGTGATCC
TAGGACATACGGACAGAAT -> AGGACATACGGACAGAATA
CCGGGCCTGGATTATGTAC -> CGGGCCTGGATTATGTACC
CACACTGCGCGTCATGGAC -> ACACTGCGCGTCATGGACG
ATGATGAGTGTTGCCTCCA -> TGATGAGTGTTGCCTCCAC
TATGTACCGTAACGAATTT -> ATGTACCGTAACGAATTTG
TGATGAGAAAAATTGATAA -> GATGAGAAAAATTGATAAA
TTACTCTAGACAAGTCGGC -> TACTCTAGACAAGTCGGCG
ATTAGCAATCGACATGCAC -> TTAGCAATCGACATGCACG
GTCCCCGAATTATGTACCG -> TCCCCGAATTATGTACCGT
CAATCAACGGATCCGCGCC -> AATCAACGGATCCGCGCCC
ATCTGAGACTAAACGCGAA -> TCTGAGACTAAACGCGAAC
CTTAGTTATCGATGCGCGG -> TTAGTTATCGATGCGCGGT
GCAATGTGCGCATAACGAG -> CAATGTGCGCATAACGAGG
TCGATCAGCTATGATCTGA -> CGATCAGCTATGATCTGAG
GAGCAAGAATCATAAAGTC -> AGCAAGAATCATAAAGTCG
GATCTGAGACTAAACGCGA -> ATCTGAGACTAAACGCGAA
CCAGAAAGATGGTTGGCTA -> CAGAAAGATGGTTGGCTAC
CGGGTAACGTCTTGTTGGG -> GGGTAACGTCTTGTTGGGA
CGGATTCGTTAACTCAGCG -> GGATTCGTTAACTCAGCGC
AACACCTTTTTTCGATCTA -> ACACCTTTTTTCGATCTAG
TTAGCCTGATTATAGCACG -> TAGCCTGATTATAGCACGG
GCGAGGACACCGTTCACTG -> CGAGGACACCGTTCACTGG
TAGCTATAGGAAGGTCTAT -> AGCTATAGGAAGGTCTATA
CACGTAGCGTTCTAATCAA -> ACGTAGCGTTCTAATCAAT
CTGGTGTGCGTTTTTCCAA -> TGGTGTGCGTTTTTCCAAT
GGGTAAATCATGCGGGTTC -> GGTAAATCATGCGGGTTCC
TAATATAATGTGGCTTAAT -> AATATAATGTGGCTTAATC
ACTCCGTTACCCGAGTAAC -> CTCCGTTACCCGAGTAACC
AGTCGAATTAATTACCGTG -> GTCGAATTAATTACCGTGG
TGTACCGTAACGAATAAAG -> GTACCGTAACGAATAAAGA
ATTAATTACCGTGGGAGAA -> TTAATTACCGTGGGAGAAC
TGTTGGGATACAGGGTGTG -> GTTGGGATACAGGGTGTGG
TGCCAGCTCACTTCTCTCT -> GCCAGCTCACTTCTCTCTC
AGGGTGGCCATCTCATGTC -> GGGTGGCCATCTCATGTCG
ATGGCATTCTGCGTATCAG -> TGGCATTCTGCGTATCAGA
CGGCCAGTATTATGTACCG -> GGCCAGTATTATGTACCGT
GTACTGATCACCCGTCGCA -> TACTGATCACCCGTCGCAA
ACGCGAACGACAGTGTAGT -> CGCGAACGACAGTGTAGTG
CCCCGAATTATGTACCGTA -> CCCGAATTATGTACCGTAA
CGTTCTAATCAATCAACGG -> GTTCTAATCAATCAACGGA
ACTGGGTACAAGAGGTTGC -> CTGGGTACAAGAGGTTGCG
ATGTGGCTTAATCTCTGGT -> TGTGGCTTAATCTCTGGTG
GATTAGAATACTGTATTAA -> ATTAGAATACTGTATTAAT
GGCCGGATTCGTTAACTCA -> GCCGGATTCGTTAACTCAG
CTTCGCTTAGGTTGGAATA -> TTCGCTTAGGTTGGAATAG
CAAGAATCATAAAGTCGCA -> AAGAATCATAAAGTCGCAC
GGGTTCCAAAAGGCTCGTC -> GGTTCCAAAAGGCTCGTCC
GTCTTGTTGGGATACAGGG -> TCTTGTTGGGATACAGGGT
GATGGGCCGGATTCGTTAA -> ATGGGCCGGATTCGTTAAC
GGACATACGGACAGAATAC -> GACATACGGACAGAATACG
TAGAGAACCGTCTCGTAGG -> AGAGAACCGTCTCGTAGGA
CAAGAATCATAAAGTCGCT -> AAGAATCATAAAGTCGCTG
GCGTTACTTACCGGTCGTA -> CGTTACTTACCGGTCGTAT
CCACGATAATTCGGGTAAA -> CACGATAATTCGGGTAAAT
GAATCATAAAGTCGCACCG -> AATCATAAAGTCGCACCGG
GCGCCGTCCCCGAATTATG -> CGCCGTCCCCGAATTATGT
CGTCTCGTAGGAATAGTGA -> GTCTCGTAGGAATAGTGAT
ATGAGTGTTGCCTCCACAA -> TGAGTGTTGCCTCCACAAG
GTCCGCGAGACTGCCGTTG -> TCCGCGAGACTGCCGTTGT
GCCTCAGCCCCGAGCCATT -> CCTCAGCCCCGAGCCATTC
GCCCGCAAAAGCCCTCATG -> CCCGCAAAAGCCCTCATGA
TTGCTAGAGCCAGGTGGAA -> TGCTAGAGCCAGGTGGAAC
TGTTTTAGAGCCGGAAGGA -> GTTTTAGAGCCGGAAGGAC
TGAGAAAAATTGATAAATT -> GAGAAAAATTGATAAATTG
GGGCTCAGGCGTTACTTAC -> GGCTCAGGCGTTACTTACC
AAGTCGCCCACGGCCAGTA -> AGTCGCCCACGGCCAGTAT
TCTGAGACTAAACGCGAAC -> CTGAGACTAAACGCGAACG
TCGCAGAGATAACCACGTC -> CGCAGAGATAACCACGTCC
TCACACCGCATCTTGCTAG -> CACACCGCATCTTGCTAGA
AAGGAGTATATAACATGTA -> AGGAGTATATAACATGTAT
AATTGTCCATACTCCGTTA -> ATTGTCCATACTCCGTTAC
AGTCGCTGTAGGACCGTAT -> GTCGCTGTAGGACCGTATT
GGTTATCATTAGCAATCGA -> GTTATCATTAGCAATCGAC
GCTCGTCCCGCTCCTGTGT -> CTCGTCCCGCTCCTGTGTG
CAGGGTGTGGGATTAGAGG -> AGGGTGTGGGATTAGAGGT
GAGTCCTACACACGTTTAT -> AGTCCTACACACGTTTATA
CACTGCGCGTCATGGACGT -> ACTGCGCGTCATGGACGTG
CTTCCGGTCGGCCCTTCAG -> TTCCGGTCGGCCCTTCAGC
TAGCGTTCTAATCAATCAA -> AGCGTTCTAATCAATCAAC
GATGGAAGACTGGGTACAA -> ATGGAAGACTGGGTACAAG
TAAACACATGCACCCCCCC -> AAACACATGCACCCCCCCC
GATCGGGTTATCATTAGCA -> ATCGGGTTATCATTAGCAA
TCGCACCGGGCCTGGATTA -> CGCACCGGGCCTGGATTAT
GACGGCTTAGTTGAAATAA -> ACGGCTTAGTTGAAATAAT
GGTGTGCGTTTTTCCAATG -> GTGTGCGTTTTTCCAATGC
CTCAGTAGGACATACGGAC -> TCAGTAGGACATACGGACA
ATTAGGAGCCAACGGCCTC -> TTAGGAGCCAACGGCCTCA
ATTAGAATACTGTATTAAT -> TTAGAATACTGTATTAATA
AATGTGACTCTGGGTAGCC -> ATGTGACTCTGGGTAGCCC
AGCAACCAACTTCTGATGA -> GCAACCAACTTCTGATGAG
CATCATGTAAGATGGAAGA -> ATCATGTAAGATGGAAGAC
CTCACTTCTCTCTCGCCCG -> TCACTTCTCTCTCGCCCGG
GTTTATAGGCTGTGCCCGC -> TTTATAGGCTGTGCCCGCA
TTATTCCCCTGTCGATCAG -> TATTCCCCTGTCGATCAGC
ACTTACCGGTCGTATACTA -> CTTACCGGTCGTATACTAA
GCAGCGAGGACACCGTTCA -> CAGCGAGGACACCGTTCAC
TTCGGCATCGAGGCTGCAA -> TCGGCATCGAGGCTGCAAC
GTGCGCATAACGAGGGTTC -> TGCGCATAACGAGGGTTCC
AAAATTGATAAATTGGGAA -> AAATTGATAAATTGGGAAC
TTAGCTTACATAGTGTCAG -> TAGCTTACATAGTGTCAGG
ATCAACCTTAAGCGGGGTT -> TCAACCTTAAGCGGGGTTT
TACCGTAACGAATAAAGAC -> ACCGTAACGAATAAAGACC
ACAAGAATCATAAAGTCGC -> CAAGAATCATAAAGTCGCA
GGATGACGGCTTAGTTGAA -> GATGACGGCTTAGTTGAAA
ACTGCGCGTCATGGACGTG -> CTGCGCGTCATGGACGTGG
AGTATCAGACTCTGTAGCA -> GTATCAGACTCTGTAGCAC
TGGGAGAACAAACGCAGGT -> GGGAGAACAAACGCAGGTC
GCGGTAGTGACGAAGGAGT -> CGGTAGTGACGAAGGAGTA
CTCATGAACAGCTACCTAT -> TCATGAACAGCTACCTATC
CCGCGCCCATGACTAAGTC -> CGCGCCCATGACTAAGTCG
TCTCTCTCGCCCGGGGATT -> CTCTCTCGCCCGGGGATTA
CCGTAACGAATTTGATGTT -> CGTAACGAATTTGATGTTA
TTCACTGGAGGTTATGTAT -> TCACTGGAGGTTATGTATC
GCATAACGAGGGTTCCTGT -> CATAACGAGGGTTCCTGTT
CGGATAGCCCCGAACTGAT -> GGATAGCCCCGAACTGATT
TCGCAATTTACGGTATGTG -> CGCAATTTACGGTATGTGA
TTCGCTCATACTCGACAGA -> TCGCTCATACTCGACAGAT
CTTACATAGTGTCAGGTCA -> TTACATAGTGTCAGGTCAG
TATGATCTGAGACTAAACG -> ATGATCTGAGACTAAACGC
AGGAATAGTGATTAGTATA -> GGAATAGTGATTAGTATAC
AAGATGGCGCCATTATATA -> AGATGGCGCCATTATATAG
GTAAATCATGCGGGTTCCA -> TAAATCATGCGGGTTCCAA
TCGTTAACTCAGCGCACTT -> CGTTAACTCAGCGCACTTT
CTATAGACATTAGGATGGG -> TATAGACATTAGGATGGGC
ACCGTAACGAATTCGGCAT -> CCGTAACGAATTCGGCATC
AGCATCGATCGCACGTAAA -> GCATCGATCGCACGTAAAG
CGCGCCCATGACTAAGTCG -> GCGCCCATGACTAAGTCGT
ACGGATCGACGCATGAGAT -> CGGATCGACGCATGAGATA
GATCCGCGCCCATGACTAA -> ATCCGCGCCCATGACTAAG
ATGTTACTCTAGACAAGTC -> TGTTACTCTAGACAAGTCG
CCTGATTATAGCACGGATC -> CTGATTATAGCACGGATCG
CGGGCCTGGATTATGTACC -> GGGCCTGGATTATGTACCG
CTCAGGCGTTACTTACCGG -> TCAGGCGTTACTTACCGGT
GAGAACAAACGCAGGTCCG -> AGAACAAACGCAGGTCCGT
GTGTAGTGGAATCCGGCGT -> TGTAGTGGAATCCGGCGTA
CCATTCTGTATAGAGAACC -> CATTCTGTATAGAGAACCG
AGAATACTGTATTAATATA -> GAATACTGTATTAATATAA
TAGAATACTGTATTAATAT -> AGAATACTGTATTAATATA
CCGTGGGAGAACAAACGCA -> CGTGGGAGAACAAACGCAG
TCCGAATTATGATAGTCGG -> CCGAATTATGATAGTCGGA
CTCTGTAGCACGTAGCGTT -> TCTGTAGCACGTAGCGTTC
ATAGTGATTAGTATACACC -> TAGTGATTAGTATACACCA
CTGTATTAATATAATGTGG -> TGTATTAATATAATGTGGC
TTTCGATTCCACCACCGTT -> TTCGATTCCACCACCGTTA
GATTATAGCACGGATCGAC -> ATTATAGCACGGATCGACG
ATGTAGCTATAGGAAGGTC -> TGTAGCTATAGGAAGGTCT
CGTAACGAATTCGGCATCG -> GTAACGAATTCGGCATCGA
ACACGTTTATACAAGAATC -> CACGTTTATACAAGAATCA
TATATGGCATTCTGCGTAT -> ATATGGCATTCTGCGTATC
TACCTATGGACTTCTTAAG -> ACCTATGGACTTCTTAAGG
TCTTTTATTCCCCTGTCGA -> CTTTTATTCCCCTGTCGAT
CTCCGGACACCCTTAACTT -> TCCGGACACCCTTAACTTA
ATAATGATTGCCGCAAAGA -> TAATGATTGCCGCAAAGAG
ACGCTTCTCGCTTAGTTAT -> CGCTTCTCGCTTAGTTATC
ACGTTTATACAAGAATCAT -> CGTTTATACAAGAATCATA
GGCCTGTTTATAGGCTGTG -> GCCTGTTTATAGGCTGTGC
ATACAGGGTGTGGGATTAG -> TACAGGGTGTGGGATTAGA
TCAGACAACTCCAGGCATG -> CAGACAACTCCAGGCATGT
CGCATGAGATATAAGCAGC -> GCATGAGATATAAGCAGCG
CAAGAATCATAAAGTCGCG -> AAGAATCATAAAGTCGCGC
CTGGATTATGTACCGTAAC -> TGGATTATGTACCGTAACG
AGTCGCGCCGTCCCCGAAT -> GTCGCGCCGTCCCCGAATT
GTTGTGACTTTCTTTACAT -> TTGTGACTTTCTTTACATT
CTTGTTGGGATACAGGGTG -> TTGTTGGGATACAGGGTGT
CTGCAATGTGCGCATAACG -> TGCAATGTGCGCATAACGA
TTCCAATGCAAATGCAGGA -> TCCAATGCAAATGCAGGAA
AATCCCAAGGCTAGGGTGG -> ATCCCAAGGCTAGGGTGGC
AACGGATCCGCGCCCATGA -> ACGGATCCGCGCCCATGAC
CACGTAAAGAAGATGGCGC -> ACGTAAAGAAGATGGCGCC
ACTATCAACCTTAAGCGGG -> CTATCAACCTTAAGCGGGG
TACCGTGGGAGAACAAACG -> ACCGTGGGAGAACAAACGC
GATCGCACGTAAAGAAGAT -> ATCGCACGTAAAGAAGATG
CGATCTAGAACCTCAATCC -> GATCTAGAACCTCAATCCG
TGTGATGGTTTTTCTATAA -> GTGATGGTTTTTCTATAAT
AATACTGTATTAATATAAT -> ATACTGTATTAATATAATG
TATCGATGCGCGGTAGTGA -> ATCGATGCGCGGTAGTGAC
CGTCAGCTCTATAGACATT -> GTCAGCTCTATAGACATTA
CTTTTTTCGATCTAGAACC -> TTTTTTCGATCTAGAACCT
ACCGTAACGAATTTGATGT -> CCGTAACGAATTTGATGTT
TTGTCCATACTCCGTTACC -> TGTCCATACTCCGTTACCC
GACGCATGAGATATAAGCA -> ACGCATGAGATATAAGCAG
ATTCCCCTGTCGATCAGCT -> TTCCCCTGTCGATCAGCTA
CCGCGTCCGCGAGACTGCC -> CGCGTCCGCGAGACTGCCG
CACGGTTATTCTACCATTG -> ACGGTTATTCTACCATTGA
ATTTACGGTATGTGAGTCC -> TTTACGGTATGTGAGTCCT
TTATCGATGCGCGGTAGTG -> TATCGATGCGCGGTAGTGA
GGAAATCCGTGAGCAAGAA -> GAAATCCGTGAGCAAGAAT
CGCCGAAATTGTCCATACT -> GCCGAAATTGTCCATACTC
GGTTATTCTACCATTGAGC -> GTTATTCTACCATTGAGCT
TACACACGTTTATACAAGA -> ACACACGTTTATACAAGAA
CGGGGAACACGGTTATTCT -> GGGGAACACGGTTATTCTA
AGGTTATGTATCAAGTGGC -> GGTTATGTATCAAGTGGCC
GGTCATAAGAGCGAGACTA -> GTCATAAGAGCGAGACTAG
GCTATAGGAAGGTCTATAG -> CTATAGGAAGGTCTATAGC
TTAAGGTCGGGTAACGTCT -> TAAGGTCGGGTAACGTCTT
TGAGAGTGGTATCTGCCCG -> GAGAGTGGTATCTGCCCGC
GAACAGTCTGATCGGGTTA -> AACAGTCTGATCGGGTTAT
GTTTGCAGTATCAGACTCT -> TTTGCAGTATCAGACTCTG
GTAACGTCTTGTTGGGATA -> TAACGTCTTGTTGGGATAC
TGGGATTAGAGGTGGATGC -> GGGATTAGAGGTGGATGCT
CTCATTAACAATGATGAGT -> TCATTAACAATGATGAGTG
ACATTAGGATGGGCCGGAT -> CATTAGGATGGGCCGGATT
TGTGCGTTTTTCCAATGCA -> GTGCGTTTTTCCAATGCAA
ATATAGCAACCAACTTCTG -> TATAGCAACCAACTTCTGA
CTTAGTTGAAATAATGTGA -> TTAGTTGAAATAATGTGAC
AAATGCAGGAATCTGCCAG -> AATGCAGGAATCTGCCAGC
CGAGTAACCTAGAAGGTCC -> GAGTAACCTAGAAGGTCCC
CGATCAGCTATGATCTGAG -> GATCAGCTATGATCTGAGA
TTGCCGCAAAGAGGGCTCA -> TGCCGCAAAGAGGGCTCAG
TGACGGCTTAGTTGAAATA -> GACGGCTTAGTTGAAATAA
AGCACGTAGCGTTCTAATC -> GCACGTAGCGTTCTAATCA
CTCAGCGCACTTTGTGGGC -> TCAGCGCACTTTGTGGGCC
TCAGACTCTGTAGCACGTA -> CAGACTCTGTAGCACGTAG
TCTCGCCCGGGGATTAGCT -> CTCGCCCGGGGATTAGCTT
TGCCCGCACACTGCGCGTC -> GCCCGCACACTGCGCGTCA
CAGTCGAATTAATTACCGT -> AGTCGAATTAATTACCGTG
AATGTGGCTTAATCTCTGG -> ATGTGGCTTAATCTCTGGT
TTTTCGATCTAGAACCTCA -> TTTCGATCTAGAACCTCAA
TATCTGCCCGCAAAAGCCC -> ATCTGCCCGCAAAAGCCCT
CCCAAGGCTAGGGTGGCCA -> CCAAGGCTAGGGTGGCCAT
GGACCGCGTCCGCGAGACT -> GACCGCGTCCGCGAGACTG
AGTGTCAGGTCAGTCGAAT -> GTGTCAGGTCAGTCGAATT
ATGGTCACCACGATAATTC -> TGGTCACCACGATAATTCG
TTGTGGGCCTGTTTATAGG -> TGTGGGCCTGTTTATAGGC
TCATTAACAATGATGAGTG -> CATTAACAATGATGAGTGT
CCGCACACTGCGCGTCATG -> CGCACACTGCGCGTCATGG
CATTCTGTATAGAGAACCG -> ATTCTGTATAGAGAACCGT
GGCTTAATCTCTGGTGTGC -> GCTTAATCTCTGGTGTGCG
ATTAGGATGGGCCGGATTC -> TTAGGATGGGCCGGATTCG
GAGCGAGACTAGTCAAGAA -> AGCGAGACTAGTCAAGAAT
CGCAATTTACGGTATGTGA -> GCAATTTACGGTATGTGAG
AGTTAGTTTGCAGTATCAG -> GTTAGTTTGCAGTATCAGA
GCATACAGGGTCATAAGAG -> CATACAGGGTCATAAGAGC
ATGTGCGCATAACGAGGGT -> TGTGCGCATAACGAGGGTT
GCTCTATAGACATTAGGAT -> CTCTATAGACATTAGGATG
CACCGGGCCTGGATTATGT -> ACCGGGCCTGGATTATGTA
CCAGGTGGAACTCATTAAC -> CAGGTGGAACTCATTAACA
TTACATAGTGTCAGGTCAG -> TACATAGTGTCAGGTCAGT
AGGTCGGGTAACGTCTTGT -> GGTCGGGTAACGTCTTGTT
AGCCCTCATGAACAGCTAC -> GCCCTCATGAACAGCTACC
CGAGACTGCCGTTGTGACT -> GAGACTGCCGTTGTGACTT
AACAGTCTGATCGGGTTAT -> ACAGTCTGATCGGGTTATC
AGACAACTCCAGGCATGTA -> GACAACTCCAGGCATGTAG
CTTAATCTCTGGTGTGCGT -> TTAATCTCTGGTGTGCGTT
AGGTCCCCACTCTGGAAAT -> GGTCCCCACTCTGGAAATC
TAATCAATCAACGGATCCG -> AATCAATCAACGGATCCGC
AGTTGAAATAATGTGACTC -> GTTGAAATAATGTGACTCT
TTAGAGGTGGATGCTGTTT -> TAGAGGTGGATGCTGTTTT
TAACGAACTATCAACCTTA -> AACGAACTATCAACCTTAA
CCGCCGCAGGCGATGACGG -> CGCCGCAGGCGATGACGGA
CTTGCTAGAGCCAGGTGGA -> TTGCTAGAGCCAGGTGGAA
TCGACAGATCACTCCGGAC -> CGACAGATCACTCCGGACA
AAGAGGTTGCGTCAAGGAC -> AGAGGTTGCGTCAAGGACC
ATACTAACGAACTATCAAC -> TACTAACGAACTATCAACC
AAAGGCTCGTCCCGCTCCT -> AAGGCTCGTCCCGCTCCTG
AACCTCAATCCGAATTATG -> ACCTCAATCCGAATTATGA
ATCATAAAGTCGCCCACGG -> TCATAAAGTCGCCCACGGC
ACACCGCATCTTGCTAGAG -> CACCGCATCTTGCTAGAGC
ATTGGGAACACCTTTTTTC -> TTGGGAACACCTTTTTTCG
TCTGGTGTGCGTTTTTCCA -> CTGGTGTGCGTTTTTCCAA
CAGGCGATGACGGATAAGT -> AGGCGATGACGGATAAGTT
TTATGTACCGTAACGAATT -> TATGTACCGTAACGAATTC,TATGTACCGTAACGAATTT
AGTCAAGAATCATAAAGTC -> GTCAAGAATCATAAAGTCG
ACATGTATATGGCATTCTG -> CATGTATATGGCATTCTGC
CGTTACTTACCGGTCGTAT -> GTTACTTACCGGTCGTATA
AGGAATCTGCCAGCTCACT -> GGAATCTGCCAGCTCACTT
GGTCCCCACTCTGGAAATC -> GTCCCCACTCTGGAAATCC
ACCCTTAACTTATGAGAGT -> CCCTTAACTTATGAGAGTG
CTATGATCTGAGACTAAAC -> TATGATCTGAGACTAAACG
AAGTTTTCGATTCCACCAC -> AGTTTTCGATTCCACCACC
CGTCTTGTTGGGATACAGG -> GTCTTGTTGGGATACAGGG
GGCGTACTGATCACCCGTC -> GCGTACTGATCACCCGTCG
GTGGGAGAACAAACGCAGG -> TGGGAGAACAAACGCAGGT
TTATCATTAGCAATCGACA -> TATCATTAGCAATCGACAT
GGTCAGTCGAATTAATTAC -> GTCAGTCGAATTAATTACC
AAATTGGGAACACCTTTTT -> AATTGGGAACACCTTTTTT
AGTCGCCCACGGCCAGTAT -> GTCGCCCACGGCCAGTATT
TCAAAGTCTCCGGAATATA -> CAAAGTCTCCGGAATATAC
TGAAATAATGTGACTCTGG -> GAAATAATGTGACTCTGGG
CCGTGTAAACACATGCACC -> CGTGTAAACACATGCACCC
TTAACTCAGCGCACTTTGT -> TAACTCAGCGCACTTTGTG
GCGTCATGGACGTGGAGGA -> CGTCATGGACGTGGAGGAT
TGGAACTCATTAACAATGA -> GGAACTCATTAACAATGAT
CCCCGAGCCATTCTGTATA -> CCCGAGCCATTCTGTATAG
ACCGGTCGTATACTAACGA -> CCGGTCGTATACTAACGAA
CGCAGGCGATGACGGATAA -> GCAGGCGATGACGGATAAG
TATGTACCGTAACGAATCC -> ATGTACCGTAACGAATCCC
TGATCCAGAAAGATGGTTG -> GATCCAGAAAGATGGTTGG
GATTAGAGGTGGATGCTGT -> ATTAGAGGTGGATGCTGTT
TACGCGATCCCGTAGAATG -> ACGCGATCCCGTAGAATGG
ATGTACCGTAACGAATTCG -> TGTACCGTAACGAATTCGG
ACAAGTCGGCGTCAGCTCT -> CAAGTCGGCGTCAGCTCTA
GCACACTGCGCGTCATGGA -> CACACTGCGCGTCATGGAC
GACACCGTTCACTGGAGGT -> ACACCGTTCACTGGAGGTT
GTCATAAGAGCGAGACTAG -> TCATAAGAGCGAGACTAGT
GGAATCCGGCGTACTGATC -> GAATCCGGCGTACTGATCA
GTCCATACTCCGTTACCCG -> TCCATACTCCGTTACCCGA
ACCGGGTGTGTATGGTTCA -> CCGGGTGTGTATGGTTCAG
AAGCGGGGTTTGAGTCACT -> AGCGGGGTTTGAGTCACTC
GTTGGAATAGTTAGTTTGC -> TTGGAATAGTTAGTTTGCA
CAGCCCCGAGCCATTCTGT -> AGCCCCGAGCCATTCTGTA
GTATAGAGAACCGTCTCGT -> TATAGAGAACCGTCTCGTA
CTAGGGTGGCCATCTCATG -> TAGGGTGGCCATCTCATGT
ACATACGGACAGAATACGC -> CATACGGACAGAATACGCG
TTCTGTATAGAGAACCGTC -> TCTGTATAGAGAACCGTCT
TTCTGCGTATCAGACAACT -> TCTGCGTATCAGACAACTC
AGTTTGCAGTATCAGACTC -> GTTTGCAGTATCAGACTCT
AGCCATTCTGTATAGAGAA -> GCCATTCTGTATAGAGAAC
TGGCTACGCTTCGCTCATA -> GGCTACGCTTCGCTCATAC
AATAATGTGACTCTGGGTA -> ATAATGTGACTCTGGGTAG
ATAAAGTCGCACCGGGCCT -> TAAAGTCGCACCGGGCCTG
CCGCAGGCGATGACGGATA -> CGCAGGCGATGACGGATAA
CACCACGATAATTCGGGTA -> ACCACGATAATTCGGGTAA
CAGATCACTCCGGACACCC -> AGATCACTCCGGACACCCT
CATAAAGTCGCACCGGGCC -> ATAAAGTCGCACCGGGCCT
TAGAGCCAGGTGGAACTCA -> AGAGCCAGGTGGAACTCAT
TAGTCGGATAGCCCCGAAC -> AGTCGGATAGCCCCGAACT
GCGATGACGGATAAGTTTT -> CGATGACGGATAAGTTTTC
TAGTGGAATCCGGCGTACT -> AGTGGAATCCGGCGTACTG
CCGTCTCGTAGGAATAGTG -> CGTCTCGTAGGAATAGTGA
ACCGTATTATGTACCGTAA -> CCGTATTATGTACCGTAAC
GTAACGAATTTGATGTTAC -> TAACGAATTTGATGTTACT
ACCCTATATGGTCACCACG -> CCCTATATGGTCACCACGA
GATATAAGCAGCGAGGACA -> ATATAAGCAGCGAGGACAC
CCCTTCGCTTAGGTTGGAA -> CCTTCGCTTAGGTTGGAAT
AGTATTATGTACCGTAACG -> GTATTATGTACCGTAACGA
TCTGCCCGCAAAAGCCCTC -> CTGCCCGCAAAAGCCCTCA
ACAGTCTGATCGGGTTATC -> CAGTCTGATCGGGTTATCA
CTGATTATAGCACGGATCG -> TGATTATAGCACGGATCGA
CATGGACGTGGAGGATGAC -> ATGGACGTGGAGGATGACG
CCGTCCCCGAATTATGTAC -> CGTCCCCGAATTATGTACC
GCCCTCATGAACAGCTACC -> CCCTCATGAACAGCTACCT
CATTAACAATGATGAGTGT -> ATTAACAATGATGAGTGTT
TTAAGAACAGTCTGATCGG -> TAAGAACAGTCTGATCGGG
TCATATTCGCTGCAATGTG -> CATATTCGCTGCAATGTGC
GCGTCAGCTCTATAGACAT -> CGTCAGCTCTATAGACATT
TAACGAATCCCAAGGCTAG -> AACGAATCCCAAGGCTAGG
TTTGATGTTACTCTAGACA -> TTGATGTTACTCTAGACAA
AGATAACCACGTCCCCACA -> GATAACCACGTCCCCACAG
GGCTAGGGTGGCCATCTCA -> GCTAGGGTGGCCATCTCAT
ATTCTACCATTGAGCTCCA -> TTCTACCATTGAGCTCCAT
CAGCGAGGACACCGTTCAC -> AGCGAGGACACCGTTCACT
ATTCTGTATAGAGAACCGT -> TTCTGTATAGAGAACCGTC
CCTAGAAGGTCCCCACTCT -> CTAGAAGGTCCCCACTCTG
GGAACACGGTTATTCTACC -> GAACACGGTTATTCTACCA
AGGTGGATGCTGTTTTAGA -> GGTGGATGCTGTTTTAGAG
GCTGTTTTAGAGCCGGAAG -> CTGTTTTAGAGCCGGAAGG
TCCGCGAGACTGCCGTTGT -> CCGCGAGACTGCCGTTGTG
AGGCGTTACTTACCGGTCG -> GGCGTTACTTACCGGTCGT
TCAGCCCCGAGCCATTCTG -> CAGCCCCGAGCCATTCTGT
TCTCGCTTAGTTATCGATG -> CTCGCTTAGTTATCGATGC
CGAGACTAGTCAAGAATCA -> GAGACTAGTCAAGAATCAT
ATTCGCTGCAATGTGCGCA -> TTCGCTGCAATGTGCGCAT
GATCCAGAAAGATGGTTGG -> ATCCAGAAAGATGGTTGGC
CTCAGCCCCGAGCCATTCT -> TCAGCCCCGAGCCATTCTG
CGCATAACGAGGGTTCCTG -> GCATAACGAGGGTTCCTGT
GACTTCTTAAGGTCGGGTA -> ACTTCTTAAGGTCGGGTAA
AAGTCGCACCGGGCCTGGA -> AGTCGCACCGGGCCTGGAT
TCACCCGTCGCAATTTACG -> CACCCGTCGCAATTTACGG
ATGCTGTTTTAGAGCCGGA -> TGCTGTTTTAGAGCCGGAA
AGGACATACGGACAGAATA -> GGACATACGGACAGAATAC
GACGTGGAGGATGACGGCT -> ACGTGGAGGATGACGGCTT
TGGAATAGTTAGTTTGCAG -> GGAATAGTTAGTTTGCAGT
ACGGTATGTGAGTCCTACA -> CGGTATGTGAGTCCTACAC
TAGACATTAGGATGGGCCG -> AGACATTAGGATGGGCCGG
GCACCGGGCCTGGATTATG -> CACCGGGCCTGGATTATGT
CACCGCATCTTGCTAGAGC -> ACCGCATCTTGCTAGAGCC
TAGCCTGATTATAGCACGG -> AGCCTGATTATAGCACGGA
TAGGAATAGTGATTAGTAT -> AGGAATAGTGATTAGTATA
GCGCCCATGACTAAGTCGT -> CGCCCATGACTAAGTCGTT
GGCCCTTCAGCTCTCTTAA -> GCCCTTCAGCTCTCTTAAA
CCCACGGCCAGTATTATGT -> CCACGGCCAGTATTATGTA
TTCCGGTGATCCAGAAAGA -> TCCGGTGATCCAGAAAGAT
CGAGGACACCGTTCACTGG -> GAGGACACCGTTCACTGGA
AAGGACCGCGTCCGCGAGA -> AGGACCGCGTCCGCGAGAC
TGAACAGCTACCTATCCCT -> GAACAGCTACCTATCCCTC
CAACGGCCTCAGCCCCGAG -> AACGGCCTCAGCCCCGAGC
AGCGAGGACACCGTTCACT -> GCGAGGACACCGTTCACTG
ACAGGGTGTGGGATTAGAG -> CAGGGTGTGGGATTAGAGG
GGCATGTAGCTATAGGAAG -> GCATGTAGCTATAGGAAGG
CAGTATTATGTACCGTAAC -> AGTATTATGTACCGTAACG
TTAATTACCGTGGGAGAAC -> TAATTACCGTGGGAGAACA
CGGCCTCAGCCCCGAGCCA -> GGCCTCAGCCCCGAGCCAT
AATTTACGGTATGTGAGTC -> ATTTACGGTATGTGAGTCC
AGATGGAAGACTGGGTACA -> GATGGAAGACTGGGTACAA
CACCCCCCCCTTCCGGTCG -> ACCCCCCCCTTCCGGTCGG
TCCCCACAGCATCGATCGC -> CCCCACAGCATCGATCGCA
CTCGCCCGGGGATTAGCTT -> TCGCCCGGGGATTAGCTTA
CATGCACGCATACAGGGTC -> ATGCACGCATACAGGGTCA
AGCTTACATAGTGTCAGGT -> GCTTACATAGTGTCAGGTC
TTGAAATAATGTGACTCTG -> TGAAATAATGTGACTCTGG
ACCATCTACCCCTGATATT -> CCATCTACCCCTGATATTG
CAGGTCCGTGTAAACACAT -> AGGTCCGTGTAAACACATG
CAGCTATGATCTGAGACTA -> AGCTATGATCTGAGACTAA
CATCGATCGCACGTAAAGA -> ATCGATCGCACGTAAAGAA
GTTATCATTAGCAATCGAC -> TTATCATTAGCAATCGACA
TTGTTGGGATACAGGGTGT -> TGTTGGGATACAGGGTGTG
GCTTCGCTCATACTCGACA -> CTTCGCTCATACTCGACAG
CTCTTTTATTCCCCTGTCG -> TCTTTTATTCCCCTGTCGA
GTCACTCTTTTATTCCCCT -> TCACTCTTTTATTCCCCTG
GGTTGGCTACGCTTCGCTC -> GTTGGCTACGCTTCGCTCA
CCCTCGCCGAAATTGTCCA -> CCTCGCCGAAATTGTCCAT
CCCCTCAGTAGGACATACG -> CCCTCAGTAGGACATACGG
TTTAGAGCCGGAAGGACCA -> TTAGAGCCGGAAGGACCAA
TACGCTTCGCTCATACTCG -> ACGCTTCGCTCATACTCGA
GCCGCAGGCGATGACGGAT -> CCGCAGGCGATGACGGATA
TCTGATCGGGTTATCATTA -> CTGATCGGGTTATCATTAG
ATCATTAGCAATCGACATG -> TCATTAGCAATCGACATGC
GATCGACGCATGAGATATA -> ATCGACGCATGAGATATAA
ATTGTCCATACTCCGTTAC -> TTGTCCATACTCCGTTACC
ATATACGCTTCTCGCTTAG -> TATACGCTTCTCGCTTAGT
ACTGTATTAATATAATGTG -> CTGTATTAATATAATGTGG
CGAACGACAGTGTAGTGGA -> GAACGACAGTGTAGTGGAA
ACGTCCCCACAGCATCGAT -> CGTCCCCACAGCATCGATC
GCCCGGGGATTAGCTTACA -> CCCGGGGATTAGCTTACAT
ATAGCAACCAACTTCTGAT -> TAGCAACCAACTTCTGATG
TCTGTAGCACGTAGCGTTC -> CTGTAGCACGTAGCGTTCT
TACGCTTCTCGCTTAGTTA -> ACGCTTCTCGCTTAGTTAT
GTTACTCTAGACAAGTCGG -> TTACTCTAGACAAGTCGGC
CTATATGGTCACCACGATA -> TATATGGTCACCACGATAA
TCATGCGGGTTCCAAAAGG -> CATGCGGGTTCCAAAAGGC
CTTATGAGAGTGGTATCTG -> TTATGAGAGTGGTATCTGC
CGTAGAATGGTCCGCCGCA -> GTAGAATGGTCCGCCGCAG
CAAGTCATCATGTAAGATG -> AAGTCATCATGTAAGATGG
CATCACACCGCATCTTGCT -> ATCACACCGCATCTTGCTA
CTAGAACCTCAATCCGAAT -> TAGAACCTCAATCCGAATT
GTTCGCAGAGATAACCACG -> TTCGCAGAGATAACCACGT
GACACCCTTAACTTATGAG -> ACACCCTTAACTTATGAGA
CCGTGAGCAAGAATCATAA -> CGTGAGCAAGAATCATAAA
CGTTCACTGGAGGTTATGT -> GTTCACTGGAGGTTATGTA
ATAACATGTATATGGCATT -> TAACATGTATATGGCATTC
GAGGTTGCGTCAAGGACCG -> AGGTTGCGTCAAGGACCGC
GCGGGGTTTGAGTCACTCT -> CGGGGTTTGAGTCACTCTT
TGTTGCTTAAGAACAGTCT -> GTTGCTTAAGAACAGTCTG
GTTACTTACCGGTCGTATA -> TTACTTACCGGTCGTATAC
TTATAGGCTGTGCCCGCAC -> TATAGGCTGTGCCCGCACA
CTAACGAACTATCAACCTT -> TAACGAACTATCAACCTTA
GTCTCCGGAATATACGCTT -> TCTCCGGAATATACGCTTC
TCATAAAGTCGCTGTAGGA -> CATAAAGTCGCTGTAGGAC
GAGCCAACGGCCTCAGCCC -> AGCCAACGGCCTCAGCCCC
AAGGTCTATAGCATCACAC -> AGGTCTATAGCATCACACC
GGGAGAACAAACGCAGGTC -> GGAGAACAAACGCAGGTCC
GTACCGTAACGAATAAAGA -> TACCGTAACGAATAAAGAC
TACTCCGTTACCCGAGTAA -> ACTCCGTTACCCGAGTAAC
AATCGGGGAACACGGTTAT -> ATCGGGGAACACGGTTATT
CCCTGTCGATCAGCTATGA -> CCTGTCGATCAGCTATGAT
TGTATATGGCATTCTGCGT -> GTATATGGCATTCTGCGTA
TCGCCCGGGGATTAGCTTA -> CGCCCGGGGATTAGCTTAC
TCAATCAACGGATCCGCGC -> CAATCAACGGATCCGCGCC
GGGCCTGTTTATAGGCTGT -> GGCCTGTTTATAGGCTGTG
CCGAATTATGATAGTCGGA -> CGAATTATGATAGTCGGAT
CGAGCCATTCTGTATAGAG -> GAGCCATTCTGTATAGAGA
GAGATAACCACGTCCCCAC -> AGATAACCACGTCCCCACA
AGTGTAGTGGAATCCGGCG -> GTGTAGTGGAATCCGGCGT
GATCCCGTAGAATGGTCCG -> ATCCCGTAGAATGGTCCGC
GATTAGCTTACATAGTGTC -> ATTAGCTTACATAGTGTCA
TGAGCAAATTAGCCTGATT -> GAGCAAATTAGCCTGATTA
TGAGATATAAGCAGCGAGG -> GAGATATAAGCAGCGAGGA
GTAGGAATAGTGATTAGTA -> TAGGAATAGTGATTAGTAT
GATGTTACTCTAGACAAGT -> ATGTTACTCTAGACAAGTC
CTTTTATTCCCCTGTCGAT -> TTTTATTCCCCTGTCGATC
TGAGCAAGAATCATAAAGT -> GAGCAAGAATCATAAAGTC
ACACACGTTTATACAAGAA -> CACACGTTTATACAAGAAT
CCACGTCCCCACAGCATCG -> CACGTCCCCACAGCATCGA
AGAGGGCTCAGGCGTTACT -> GAGGGCTCAGGCGTTACTT
GACTCTGTAGCACGTAGCG -> ACTCTGTAGCACGTAGCGT
ACAACTCCAGGCATGTAGC -> CAACTCCAGGCATGTAGCT
AAGAATCATAAAGTCGCTG -> AGAATCATAAAGTCGCTGT
CGCTTCGCTCATACTCGAC -> GCTTCGCTCATACTCGACA
GTATCTGCCCGCAAAAGCC -> TATCTGCCCGCAAAAGCCC
TGGATTATGTACCGTAACG -> GGATTATGTACCGTAACGA
ACACATGCACCCCCCCCTT -> CACATGCACCCCCCCCTTC
CGGACACCCTTAACTTATG -> GGACACCCTTAACTTATGA
CGAGGGTTCCTGTTGCTTA -> GAGGGTTCCTGTTGCTTAA
GTTGCTTAAGAACAGTCTG -> TTGCTTAAGAACAGTCTGA
TACTAACGAACTATCAACC -> ACTAACGAACTATCAACCT
ATCGACGCATGAGATATAA -> TCGACGCATGAGATATAAG
ATCATAAAGTCGCACCGGG -> TCATAAAGTCGCACCGGGC
GGTACAAGAGGTTGCGTCA -> GTACAAGAGGTTGCGTCAA
GGTCGGCCCTTCAGCTCTC -> GTCGGCCCTTCAGCTCTCT
AAGAAGGTCAAAGTCTCCG -> AGAAGGTCAAAGTCTCCGG
ATTAGCTTACATAGTGTCA -> TTAGCTTACATAGTGTCAG
CCTGGATTATGTACCGTAA -> CTGGATTATGTACCGTAAC
CGCACTTTGTGGGCCTGTT -> GCACTTTGTGGGCCTGTTT
GGAGAACAAACGCAGGTCC -> GAGAACAAACGCAGGTCCG
ATAAAGACCGGGTGTGTAT -> TAAAGACCGGGTGTGTATG
ACCGTTCACTGGAGGTTAT -> CCGTTCACTGGAGGTTATG
TGGGAACACCTTTTTTCGA -> GGGAACACCTTTTTTCGAT
TATAACATGTATATGGCAT -> ATAACATGTATATGGCATT
AATTACCGTGGGAGAACAA -> ATTACCGTGGGAGAACAAA
GAAAAATTGATAAATTGGG -> AAAAATTGATAAATTGGGA
CTCTGGGTAGCCCCTTCGC -> TCTGGGTAGCCCCTTCGCT
TCTGCGTATCAGACAACTC -> CTGCGTATCAGACAACTCC
GGAATCTGCCAGCTCACTT -> GAATCTGCCAGCTCACTTC
TGGTTGGCTACGCTTCGCT -> GGTTGGCTACGCTTCGCTC
ACTCATTAACAATGATGAG -> CTCATTAACAATGATGAGT
CTTAAGCGGGGTTTGAGTC -> TTAAGCGGGGTTTGAGTCA
AACACGGTTATTCTACCAT -> ACACGGTTATTCTACCATT
CCTACACACGTTTATACAA -> CTACACACGTTTATACAAG
TGAGTCACTCTTTTATTCC -> GAGTCACTCTTTTATTCCC
CCGAGCCATTCTGTATAGA -> CGAGCCATTCTGTATAGAG
ATATTTCCGGTGATCCAGA -> TATTTCCGGTGATCCAGAA
TAGAATGGTCCGCCGCAGG -> AGAATGGTCCGCCGCAGGC
TGTGGCTTAATCTCTGGTG -> GTGGCTTAATCTCTGGTGT
CTCATGTCGATATTTCCGG -> TCATGTCGATATTTCCGGT
GTACCGTAACGAATTTGAT -> TACCGTAACGAATTTGATG
CGCCGCAGGCGATGACGGA -> GCCGCAGGCGATGACGGAT
ACACCTTTTTTCGATCTAG -> CACCTTTTTTCGATCTAGA
ACGAAGGAGTATATAACAT -> CGAAGGAGTATATAACATG
AGGATGACGGCTTAGTTGA -> GGATGACGGCTTAGTTGAA
ATAAATTGGGAACACCTTT -> TAAATTGGGAACACCTTTT
GCCGGATTCGTTAACTCAG -> CCGGATTCGTTAACTCAGC
TCATAAGAGCGAGACTAGT -> CATAAGAGCGAGACTAGTC
AGACTAGTCAAGAATCATA -> GACTAGTCAAGAATCATAA
TCATAAAGTCGCGCCGTCC -> CATAAAGTCGCGCCGTCCC
CACGTTTATACAAGAATCA -> ACGTTTATACAAGAATCAT
TATTTCCGGTGATCCAGAA -> ATTTCCGGTGATCCAGAAA
CGACATGCACGCATACAGG -> GACATGCACGCATACAGGG
GTCCGCCGCAGGCGATGAC -> TCCGCCGCAGGCGATGACG
TGTACCGTAACGAATTTGA -> GTACCGTAACGAATTTGAT
ATGGTTTTTCTATAATGAT -> TGGTTTTTCTATAATGATT
ACAAACGCAGGTCCGTGTA -> CAAACGCAGGTCCGTGTAA
AACAAACGCAGGTCCGTGT -> ACAAACGCAGGTCCGTGTA
AGAATCATAAAGTCGCACC -> GAATCATAAAGTCGCACCG
CGCGGTAGTGACGAAGGAG -> GCGGTAGTGACGAAGGAGT
TTTTATTCCCCTGTCGATC -> TTTATTCCCCTGTCGATCA
CTAAACGCGAACGACAGTG -> TAAACGCGAACGACAGTGT
AATGCAAATGCAGGAATCT -> ATGCAAATGCAGGAATCTG
GGATCCGCGCCCATGACTA -> GATCCGCGCCCATGACTAA
CGAACTATCAACCTTAAGC -> GAACTATCAACCTTAAGCG
GAATTCGGCATCGAGGCTG -> AATTCGGCATCGAGGCTGC
TTAATATAATGTGGCTTAA -> TAATATAATGTGGCTTAAT
GAACAGCTACCTATCCCTC -> AACAGCTACCTATCCCTCG
TGAAGCGTGTGATGGTTTT -> GAAGCGTGTGATGGTTTTT
CCTCATGAACAGCTACCTA -> CTCATGAACAGCTACCTAT
CACCACCGTTAATTAGGAG -> ACCACCGTTAATTAGGAGC
GTATACACCATCTACCCCT -> TATACACCATCTACCCCTG
CCCCCCCCTTCCGGTCGGC -> CCCCCCCTTCCGGTCGGCC
CAACTTCTGATGAGAAAAA -> AACTTCTGATGAGAAAAAT
CGTTGTGACTTTCTTTACA -> GTTGTGACTTTCTTTACAT
AGCCAGGTGGAACTCATTA -> GCCAGGTGGAACTCATTAA
ACTGGAGGTTATGTATCAA -> CTGGAGGTTATGTATCAAG
TACAGGGTGTGGGATTAGA -> ACAGGGTGTGGGATTAGAG
TCATGTAAGATGGAAGACT -> CATGTAAGATGGAAGACTG
TGCCCGCAAAAGCCCTCAT -> GCCCGCAAAAGCCCTCATG
TACAAGAATCATAAAGTCG -> ACAAGAATCATAAAGTCGC
TAGTTGAAATAATGTGACT -> AGTTGAAATAATGTGACTC
ATACGCGATCCCGTAGAAT -> TACGCGATCCCGTAGAATG
ACTGCCGTTGTGACTTTCT -> CTGCCGTTGTGACTTTCTT
TCATGGACGTGGAGGATGA -> CATGGACGTGGAGGATGAC
GCTTAGTTATCGATGCGCG -> CTTAGTTATCGATGCGCGG
TACATAGTGTCAGGTCAGT -> ACATAGTGTCAGGTCAGTC
GTTTTCGATTCCACCACCG -> TTTTCGATTCCACCACCGT
GGAGGTTATGTATCAAGTG -> GAGGTTATGTATCAAGTGG
ACTGATTAGAATACTGTAT -> CTGATTAGAATACTGTATT
AACGAATAAAGACCGGGTG -> ACGAATAAAGACCGGGTGT
TTCGATCTAGAACCTCAAT -> TCGATCTAGAACCTCAATC
AGAATCATAAAGTCGCGCC -> GAATCATAAAGTCGCGCCG
AGAATCATAAAGTCGCCCA -> GAATCATAAAGTCGCCCAC
TAGTGATTAGTATACACCA -> AGTGATTAGTATACACCAT
CTGTTTTAGAGCCGGAAGG -> TGTTTTAGAGCCGGAAGGA
CCTTAACTTATGAGAGTGG -> CTTAACTTATGAGAGTGGT
ATAGTCGGATAGCCCCGAA -> TAGTCGGATAGCCCCGAAC
AGGAGTATATAACATGTAT -> GGAGTATATAACATGTATA
ACGAACTATCAACCTTAAG -> CGAACTATCAACCTTAAGC
GAGAAAAATTGATAAATTG -> AGAAAAATTGATAAATTGG
TGTGACTTTCTTTACATTC -> GTGACTTTCTTTACATTCC
ACGTAAAGAAGATGGCGCC -> CGTAAAGAAGATGGCGCCA
CTAGAGCCAGGTGGAACTC -> TAGAGCCAGGTGGAACTCA
ACCATTGAGCTCCATGAGC -> CCATTGAGCTCCATGAGCA
ATAGGCTGTGCCCGCACAC -> TAGGCTGTGCCCGCACACT
ATGTACCGTAACGAATAAA -> TGTACCGTAACGAATAAAG
GAGTGTTGCCTCCACAAGT -> AGTGTTGCCTCCACAAGTC
ATAAAGTCGCGCCGTCCCC -> TAAAGTCGCGCCGTCCCCG
GCTTAGGTTGGAATAGTTA -> CTTAGGTTGGAATAGTTAG
TTTACGGTATGTGAGTCCT -> TTACGGTATGTGAGTCCTA
TGTATGGTTCAGGAAGAAG -> GTATGGTTCAGGAAGAAGG
GAATCATAAAGTCGCGCCG -> AATCATAAAGTCGCGCCGT
TCAAGAATCATAAAGTCGC -> CAAGAATCATAAAGTCGCT
TGCTAGAGCCAGGTGGAAC -> GCTAGAGCCAGGTGGAACT
TTAGTATACACCATCTACC -> TAGTATACACCATCTACCC
ATCCGCGCCCATGACTAAG -> TCCGCGCCCATGACTAAGT
GTTGCGTCAAGGACCGCGT -> TTGCGTCAAGGACCGCGTC
TCAGCTATGATCTGAGACT -> CAGCTATGATCTGAGACTA
ACGAATTTGATGTTACTCT -> CGAATTTGATGTTACTCTA
CCTCCACAAGTCATCATGT -> CTCCACAAGTCATCATGTA
GTATATAACATGTATATGG -> TATATAACATGTATATGGC
ACAAGTCATCATGTAAGAT -> CAAGTCATCATGTAAGATG
GGAGTATATAACATGTATA -> GAGTATATAACATGTATAT
GACGAAGGAGTATATAACA -> ACGAAGGAGTATATAACAT
AATCATAAAGTCGCTGTAG -> ATCATAAAGTCGCTGTAGG
GTTAATTAGGAGCCAACGG -> TTAATTAGGAGCCAACGGC
ATCGATGCGCGGTAGTGAC -> TCGATGCGCGGTAGTGACG
TGTGAAGCGTGTGATGGTT -> GTGAAGCGTGTGATGGTTT
GGAAGGACCAAGAATCATA -> GAAGGACCAAGAATCATAA
TAACCACGTCCCCACAGCA -> AACCACGTCCCCACAGCAT
CAAGTCGGCGTCAGCTCTA -> AAGTCGGCGTCAGCTCTAT
GGGTACAAGAGGTTGCGTC -> GGTACAAGAGGTTGCGTCA
TCCTACACACGTTTATACA -> CCTACACACGTTTATACAA
GGATAGCCCCGAACTGATT -> GATAGCCCCGAACTGATTA
GCGCGGTAGTGACGAAGGA -> CGCGGTAGTGACGAAGGAG
AGCCTGATTATAGCACGGA -> GCCTGATTATAGCACGGAT
GCTACCTATCCCTCGCCGA -> CTACCTATCCCTCGCCGAA
GTAAAGAAGATGGCGCCAT -> TAAAGAAGATGGCGCCATT
CAAACGCAGGTCCGTGTAA -> AAACGCAGGTCCGTGTAAA
CCGTAACGAATCCCAAGGC -> CGTAACGAATCCCAAGGCT
ACTCTAGACAAGTCGGCGT -> CTCTAGACAAGTCGGCGTC
CGCCCACGGCCAGTATTAT -> GCCCACGGCCAGTATTATG
TGATGGTTTTTCTATAATG -> GATGGTTTTTCTATAATGA
TACAAGAGGTTGCGTCAAG -> ACAAGAGGTTGCGTCAAGG
AGACAAGTCGGCGTCAGCT -> GACAAGTCGGCGTCAGCTC
AATTCGGCATCGAGGCTGC -> ATTCGGCATCGAGGCTGCA
GCTCCATGAGCAAATTAGC -> CTCCATGAGCAAATTAGCC
CTACCTATCCCTCGCCGAA -> TACCTATCCCTCGCCGAAA
CCCGCAAAAGCCCTCATGA -> CCGCAAAAGCCCTCATGAA
TTTATACAAGAATCATAAA -> TTATACAAGAATCATAAAG
GTGTGCGTTTTTCCAATGC -> TGTGCGTTTTTCCAATGCA
ACTTATGAGAGTGGTATCT -> CTTATGAGAGTGGTATCTG
GCTCCTGTGTGAAGCGTGT -> CTCCTGTGTGAAGCGTGTG
AAAGTCGCGCCGTCCCCGA -> AAGTCGCGCCGTCCCCGAA
TTTTCTATAATGATTGCCG -> TTTCTATAATGATTGCCGC
TCAGTCGAATTAATTACCG -> CAGTCGAATTAATTACCGT
CTGTTGCTTAAGAACAGTC -> TGTTGCTTAAGAACAGTCT
TGACGGATAAGTTTTCGAT -> GACGGATAAGTTTTCGATT
GAAGGTCCCCACTCTGGAA -> AAGGTCCCCACTCTGGAAA
TTCCCCTGTCGATCAGCTA -> TCCCCTGTCGATCAGCTAT
TCTGATGAGAAAAATTGAT -> CTGATGAGAAAAATTGATA
CACCCTTAACTTATGAGAG -> ACCCTTAACTTATGAGAGT
ATGTGACTCTGGGTAGCCC -> TGTGACTCTGGGTAGCCCC
CTTAAGAACAGTCTGATCG -> TTAAGAACAGTCTGATCGG
TACTCGACAGATCACTCCG -> ACTCGACAGATCACTCCGG
TTGATAAATTGGGAACACC -> TGATAAATTGGGAACACCT
AACGAATTTGATGTTACTC -> ACGAATTTGATGTTACTCT
GTTCACTGGAGGTTATGTA -> TTCACTGGAGGTTATGTAT
CAAGGCTAGGGTGGCCATC -> AAGGCTAGGGTGGCCATCT
CCCCACAGCATCGATCGCA -> CCCACAGCATCGATCGCAC
ATTCGGGTAAATCATGCGG -> TTCGGGTAAATCATGCGGG
CCCGTAGAATGGTCCGCCG -> CCGTAGAATGGTCCGCCGC
TAACGAGGGTTCCTGTTGC -> AACGAGGGTTCCTGTTGCT
TTCGTTAACTCAGCGCACT -> TCGTTAACTCAGCGCACTT
TTTTCCAATGCAAATGCAG -> TTTCCAATGCAAATGCAGG
AGGCGATGACGGATAAGTT -> GGCGATGACGGATAAGTTT
GAACCGTCTCGTAGGAATA -> AACCGTCTCGTAGGAATAG
TATAGCAACCAACTTCTGA -> ATAGCAACCAACTTCTGAT
TCATAAAGTCGCCCACGGC -> CATAAAGTCGCCCACGGCC
ATACGGACAGAATACGCGA -> TACGGACAGAATACGCGAT
GACATACGGACAGAATACG -> ACATACGGACAGAATACGC
CACCGTTAATTAGGAGCCA -> ACCGTTAATTAGGAGCCAA
TGTCCATACTCCGTTACCC -> GTCCATACTCCGTTACCCG
GATCTAGAACCTCAATCCG -> ATCTAGAACCTCAATCCGA
GTGGCCCCTCAGTAGGACA -> TGGCCCCTCAGTAGGACAT
CCGTTAATTAGGAGCCAAC -> CGTTAATTAGGAGCCAACG
ATGACGGCTTAGTTGAAAT -> TGACGGCTTAGTTGAAATA
TAACATGTATATGGCATTC -> AACATGTATATGGCATTCT
CATCTTGCTAGAGCCAGGT -> ATCTTGCTAGAGCCAGGTG
ACTTTGTGGGCCTGTTTAT -> CTTTGTGGGCCTGTTTATA
ATTATATAGCAACCAACTT -> TTATATAGCAACCAACTTC
CATTAGGATGGGCCGGATT -> ATTAGGATGGGCCGGATTC
CTCCAGGCATGTAGCTATA -> TCCAGGCATGTAGCTATAG
TACAGGGTCATAAGAGCGA -> ACAGGGTCATAAGAGCGAG
GTGGTATCTGCCCGCAAAA -> TGGTATCTGCCCGCAAAAG
TAGAAGGTCCCCACTCTGG -> AGAAGGTCCCCACTCTGGA
AGAAGGTCCCCACTCTGGA -> GAAGGTCCCCACTCTGGAA
CTGTTTATAGGCTGTGCCC -> TGTTTATAGGCTGTGCCCG
GAGCAAATTAGCCTGATTA -> AGCAAATTAGCCTGATTAT
CTGTAGGACCGTATTATGT -> TGTAGGACCGTATTATGTA
GGTCTATAGCATCACACCG -> GTCTATAGCATCACACCGC
GACTAGTCAAGAATCATAA -> ACTAGTCAAGAATCATAAA
TCGGGGAACACGGTTATTC -> CGGGGAACACGGTTATTCT
ACACTGCGCGTCATGGACG -> CACTGCGCGTCATGGACGT
CAAGAGGTTGCGTCAAGGA -> AAGAGGTTGCGTCAAGGAC
GGACCAAGAATCATAAAGT -> GACCAAGAATCATAAAGTC
ACCACCGTTAATTAGGAGC -> CCACCGTTAATTAGGAGCC
TTAACTTATGAGAGTGGTA -> TAACTTATGAGAGTGGTAT
TCGACATGCACGCATACAG -> CGACATGCACGCATACAGG
GAAAGATGGTTGGCTACGC -> AAAGATGGTTGGCTACGCT
GATTATGTACCGTAACGAA -> ATTATGTACCGTAACGAAT
TCACTCCGGACACCCTTAA -> CACTCCGGACACCCTTAAC
CGTAGGAATAGTGATTAGT -> GTAGGAATAGTGATTAGTA
CATCTACCCCTGATATTGT -> ATCTACCCCTGATATTGTA
CTCCGTTACCCGAGTAACC -> TCCGTTACCCGAGTAACCT
TCGTTCGCAGAGATAACCA -> CGTTCGCAGAGATAACCAC
CCGAACTGATTAGAATACT -> CGAACTGATTAGAATACTG
ATTGTACCTATGGACTTCT -> TTGTACCTATGGACTTCTT
GAGGTTATGTATCAAGTGG -> AGGTTATGTATCAAGTGGC
GGGTAGCCCCTTCGCTTAG -> GGTAGCCCCTTCGCTTAGG
CTTAACTTATGAGAGTGGT -> TTAACTTATGAGAGTGGTA
CGCAGGTCCGTGTAAACAC -> GCAGGTCCGTGTAAACACA
GGCTCAGGCGTTACTTACC -> GCTCAGGCGTTACTTACCG
ACGGATAAGTTTTCGATTC -> CGGATAAGTTTTCGATTCC
AGAACCTCAATCCGAATTA -> GAACCTCAATCCGAATTAT
TCGCTTAGTTATCGATGCG -> CGCTTAGTTATCGATGCGC
TTGCTTAAGAACAGTCTGA -> TGCTTAAGAACAGTCTGAT
CGTAACGAATCCCAAGGCT -> GTAACGAATCCCAAGGCTA
AGAGGTTGCGTCAAGGACC -> GAGGTTGCGTCAAGGACCG
ATCAACGGATCCGCGCCCA -> TCAACGGATCCGCGCCCAT
CTGCCGTTGTGACTTTCTT -> TGCCGTTGTGACTTTCTTT
GTAGCCCCTTCGCTTAGGT -> TAGCCCCTTCGCTTAGGTT
TGATAAATTGGGAACACCT -> GATAAATTGGGAACACCTT
CGATGACGGATAAGTTTTC -> GATGACGGATAAGTTTTCG
CTACCATTGAGCTCCATGA -> TACCATTGAGCTCCATGAG
ATCATAAAGTCGCTGTAGG -> TCATAAAGTCGCTGTAGGA
TCTCGTAGGAATAGTGATT -> CTCGTAGGAATAGTGATTA
ACTAACGAACTATCAACCT -> CTAACGAACTATCAACCTT
CCCCTGATATTGTACCTAT -> CCCTGATATTGTACCTATG
CACCCGTCGCAATTTACGG -> ACCCGTCGCAATTTACGGT
GCAAATTAGCCTGATTATA -> CAAATTAGCCTGATTATAG
AGCAAATTAGCCTGATTAT -> GCAAATTAGCCTGATTATA
AAGTCGCTGTAGGACCGTA -> AGTCGCTGTAGGACCGTAT
CACACGTTTATACAAGAAT -> ACACGTTTATACAAGAATC
CATAAAGTCGCTGTAGGAC -> ATAAAGTCGCTGTAGGACC
AGATGGTTGGCTACGCTTC -> GATGGTTGGCTACGCTTCG
CGTATACTAACGAACTATC -> GTATACTAACGAACTATCA
CGTTTATACAAGAATCATA -> GTTTATACAAGAATCATAA
GGGTAACGTCTTGTTGGGA -> GGTAACGTCTTGTTGGGAT
GAATCCCAAGGCTAGGGTG -> AATCCCAAGGCTAGGGTGG
GAAATAATGTGACTCTGGG -> AAATAATGTGACTCTGGGT
AGACCGGGTGTGTATGGTT -> GACCGGGTGTGTATGGTTC
GTGGAGGATGACGGCTTAG -> TGGAGGATGACGGCTTAGT
TGAGTCCTACACACGTTTA -> GAGTCCTACACACGTTTAT
CCTATGGACTTCTTAAGGT -> CTATGGACTTCTTAAGGTC
AGCTCTCTTAAATCGGGGA -> GCTCTCTTAAATCGGGGAA
GAACTATCAACCTTAAGCG -> AACTATCAACCTTAAGCGG
TTTCCGGTGATCCAGAAAG -> TTCCGGTGATCCAGAAAGA
AGGCTCGTCCCGCTCCTGT -> GGCTCGTCCCGCTCCTGTG
TCTATAGCATCACACCGCA -> CTATAGCATCACACCGCAT
ATAATTCGGGTAAATCATG -> TAATTCGGGTAAATCATGC
GACTAAACGCGAACGACAG -> ACTAAACGCGAACGACAGT
TCGCACGTAAAGAAGATGG -> CGCACGTAAAGAAGATGGC
TCTCCGGAATATACGCTTC -> CTCCGGAATATACGCTTCT
TTGTGACTTTCTTTACATT -> TGTGACTTTCTTTACATTC
GCACGGATCGACGCATGAG -> CACGGATCGACGCATGAGA
CGAAGGAGTATATAACATG -> GAAGGAGTATATAACATGT
GCGAACGACAGTGTAGTGG -> CGAACGACAGTGTAGTGGA
GCCTGTTTATAGGCTGTGC -> CCTGTTTATAGGCTGTGCC
GCCATTATATAGCAACCAA -> CCATTATATAGCAACCAAC
TATGGTTCAGGAAGAAGGT -> ATGGTTCAGGAAGAAGGTC
TCAGGAAGAAGGTCAAAGT -> CAGGAAGAAGGTCAAAGTC
CTGTCGATCAGCTATGATC -> TGTCGATCAGCTATGATCT
GCGTGTGATGGTTTTTCTA -> CGTGTGATGGTTTTTCTAT
GGATTATGTACCGTAACGA -> GATTATGTACCGTAACGAA
CCCTTCCGGTCGGCCCTTC -> CCTTCCGGTCGGCCCTTCA
TTGTACCTATGGACTTCTT -> TGTACCTATGGACTTCTTA
GGTCGTATACTAACGAACT -> GTCGTATACTAACGAACTA
GCCGAAATTGTCCATACTC -> CCGAAATTGTCCATACTCC
GGGTCATAAGAGCGAGACT -> GGTCATAAGAGCGAGACTA
CCAGGCATGTAGCTATAGG -> CAGGCATGTAGCTATAGGA
GTGATGGTTTTTCTATAAT -> TGATGGTTTTTCTATAATG
CAAATTAGCCTGATTATAG -> AAATTAGCCTGATTATAGC
CGTAGCGTTCTAATCAATC -> GTAGCGTTCTAATCAATCA
CGTTAACTCAGCGCACTTT -> GTTAACTCAGCGCACTTTG
CACGTCCCCACAGCATCGA -> ACGTCCCCACAGCATCGAT
GGTGTGGGATTAGAGGTGG -> GTGTGGGATTAGAGGTGGA
GAATAGTGATTAGTATACA -> AATAGTGATTAGTATACAC
TCGACGCATGAGATATAAG -> CGACGCATGAGATATAAGC
GCCAACGGCCTCAGCCCCG -> CCAACGGCCTCAGCCCCGA
GACAAGTCGGCGTCAGCTC -> ACAAGTCGGCGTCAGCTCT
GCTAGAGCCAGGTGGAACT -> CTAGAGCCAGGTGGAACTC
CCGTAACGAATTCGGCATC -> CGTAACGAATTCGGCATCG
ATCATGTAAGATGGAAGAC -> TCATGTAAGATGGAAGACT
AACCTTAAGCGGGGTTTGA -> ACCTTAAGCGGGGTTTGAG
CCCGCACACTGCGCGTCAT -> CCGCACACTGCGCGTCATG
AGCGTGTGATGGTTTTTCT -> GCGTGTGATGGTTTTTCTA
TTCGGGTAAATCATGCGGG -> TCGGGTAAATCATGCGGGT
CTTCGCTCATACTCGACAG -> TTCGCTCATACTCGACAGA
AGAGAACCGTCTCGTAGGA -> GAGAACCGTCTCGTAGGAA
CTGTAGCACGTAGCGTTCT -> TGTAGCACGTAGCGTTCTA
ACGCGATCCCGTAGAATGG -> CGCGATCCCGTAGAATGGT
CCGGTGATCCAGAAAGATG -> CGGTGATCCAGAAAGATGG
CATGCACCCCCCCCTTCCG -> ATGCACCCCCCCCTTCCGG
TGATTGCCGCAAAGAGGGC -> GATTGCCGCAAAGAGGGCT
GGCATTCTGCGTATCAGAC -> GCATTCTGCGTATCAGACA
CCACAGCATCGATCGCACG -> CACAGCATCGATCGCACGT
GAATTTGATGTTACTCTAG -> AATTTGATGTTACTCTAGA
TAACGAATTTGATGTTACT -> AACGAATTTGATGTTACTC
CGGATAAGTTTTCGATTCC -> GGATAAGTTTTCGATTCCA
GCTAGGGTGGCCATCTCAT -> CTAGGGTGGCCATCTCATG
TCGCTGTAGGACCGTATTA -> CGCTGTAGGACCGTATTAT
ATGAGCAAATTAGCCTGAT -> TGAGCAAATTAGCCTGATT
GTCATATTCGCTGCAATGT -> TCATATTCGCTGCAATGTG
CTCTCTCGCCCGGGGATTA -> TCTCTCGCCCGGGGATTAG
ACCTATGGACTTCTTAAGG -> CCTATGGACTTCTTAAGGT
CTTCTCGCTTAGTTATCGA -> TTCTCGCTTAGTTATCGAT
AAATAATGTGACTCTGGGT -> AATAATGTGACTCTGGGTA
GTCTGATCGGGTTATCATT -> TCTGATCGGGTTATCATTA
ACACCCTTAACTTATGAGA -> CACCCTTAACTTATGAGAG
CAGTATCAGACTCTGTAGC -> AGTATCAGACTCTGTAGCA
TAGCCCCTTCGCTTAGGTT -> AGCCCCTTCGCTTAGGTTG
CCGAGTAACCTAGAAGGTC -> CGAGTAACCTAGAAGGTCC
AGGGCTCAGGCGTTACTTA -> GGGCTCAGGCGTTACTTAC
GTCTCGTAGGAATAGTGAT -> TCTCGTAGGAATAGTGATT
AGACTAAACGCGAACGACA -> GACTAAACGCGAACGACAG
CGTCAAGGACCGCGTCCGC -> GTCAAGGACCGCGTCCGCG
GTTTGAGTCACTCTTTTAT -> TTTGAGTCACTCTTTTATT
CGCTGCAATGTGCGCATAA -> GCTGCAATGTGCGCATAAC
CTGGAGGTTATGTATCAAG -> TGGAGGTTATGTATCAAGT
GTATCAGACTCTGTAGCAC -> TATCAGACTCTGTAGCACG
AATTCGGGTAAATCATGCG -> ATTCGGGTAAATCATGCGG
CCGGCGTACTGATCACCCG -> CGGCGTACTGATCACCCGT
CCGCATCTTGCTAGAGCCA -> CGCATCTTGCTAGAGCCAG
AGCTCCATGAGCAAATTAG -> GCTCCATGAGCAAATTAGC
CGAATTAATTACCGTGGGA -> GAATTAATTACCGTGGGAG
AGTATACACCATCTACCCC -> GTATACACCATCTACCCCT
CAGACTCTGTAGCACGTAG -> AGACTCTGTAGCACGTAGC
CATGCGGGTTCCAAAAGGC -> ATGCGGGTTCCAAAAGGCT
TCCGTTACCCGAGTAACCT -> CCGTTACCCGAGTAACCTA
GATAAATTGGGAACACCTT -> ATAAATTGGGAACACCTTT
TTGCGTCAAGGACCGCGTC -> TGCGTCAAGGACCGCGTCC
GGCCTCAGCCCCGAGCCAT -> GCCTCAGCCCCGAGCCATT
ATTATGATAGTCGGATAGC -> TTATGATAGTCGGATAGCC
ATCGCACGTAAAGAAGATG -> TCGCACGTAAAGAAGATGG
TAAAGTCGCCCACGGCCAG -> AAAGTCGCCCACGGCCAGT
AATCGACATGCACGCATAC -> ATCGACATGCACGCATACA
ATTCGTTAACTCAGCGCAC -> TTCGTTAACTCAGCGCACT
GGGTGGCCATCTCATGTCG -> GGTGGCCATCTCATGTCGA
CTATAGCATCACACCGCAT -> TATAGCATCACACCGCATC
GTCAAAGTCTCCGGAATAT -> TCAAAGTCTCCGGAATATA
CATAAGAGCGAGACTAGTC -> ATAAGAGCGAGACTAGTCA
GAACCTCAATCCGAATTAT -> AACCTCAATCCGAATTATG
TAATGTGGCTTAATCTCTG -> AATGTGGCTTAATCTCTGG
GGTTTGAGTCACTCTTTTA -> GTTTGAGTCACTCTTTTAT
ATCTGCCAGCTCACTTCTC -> TCTGCCAGCTCACTTCTCT
AGCACGGATCGACGCATGA -> GCACGGATCGACGCATGAG
ACTCGACAGATCACTCCGG -> CTCGACAGATCACTCCGGA
TTAGAATACTGTATTAATA -> TAGAATACTGTATTAATAT
CGTGGGAGAACAAACGCAG -> GTGGGAGAACAAACGCAGG
TAGCAACCAACTTCTGATG -> AGCAACCAACTTCTGATGA
AACTTCTGATGAGAAAAAT -> ACTTCTGATGAGAAAAATT
CATTCTGCGTATCAGACAA -> ATTCTGCGTATCAGACAAC
AACACATGCACCCCCCCCT -> ACACATGCACCCCCCCCTT
CTCGTAGGAATAGTGATTA -> TCGTAGGAATAGTGATTAG
CAAGTGGCCCCTCAGTAGG -> AAGTGGCCCCTCAGTAGGA
GAATTAATTACCGTGGGAG -> AATTAATTACCGTGGGAGA
CAGTGTAGTGGAATCCGGC -> AGTGTAGTGGAATCCGGCG
TCCATGAGCAAATTAGCCT -> CCATGAGCAAATTAGCCTG
TGTATAGAGAACCGTCTCG -> GTATAGAGAACCGTCTCGT
CAACGGATCCGCGCCCATG -> AACGGATCCGCGCCCATGA
CACGGCCAGTATTATGTAC -> ACGGCCAGTATTATGTACC
TGTACCGTAACGAATTCGG -> GTACCGTAACGAATTCGGC
GAAGGTCTATAGCATCACA -> AAGGTCTATAGCATCACAC
CAACCTTAAGCGGGGTTTG -> AACCTTAAGCGGGGTTTGA
ATCCGTGAGCAAGAATCAT -> TCCGTGAGCAAGAATCATA
ACGCATACAGGGTCATAAG -> CGCATACAGGGTCATAAGA
ACAGAATACGCGATCCCGT -> CAGAATACGCGATCCCGTA
TGATTATAGCACGGATCGA -> GATTATAGCACGGATCGAC
ACCTAGAAGGTCCCCACTC -> CCTAGAAGGTCCCCACTCT
GGTTATGTATCAAGTGGCC -> GTTATGTATCAAGTGGCCC
CGCATACAGGGTCATAAGA -> GCATACAGGGTCATAAGAG
ATTGATAAATTGGGAACAC -> TTGATAAATTGGGAACACC
ATGGAAGACTGGGTACAAG -> TGGAAGACTGGGTACAAGA
AGCAGCGAGGACACCGTTC -> GCAGCGAGGACACCGTTCA
GGGATTAGCTTACATAGTG -> GGATTAGCTTACATAGTGT
AGTGGAATCCGGCGTACTG -> GTGGAATCCGGCGTACTGA
GTCGTTCGCAGAGATAACC -> TCGTTCGCAGAGATAACCA
ACATAGTGTCAGGTCAGTC -> CATAGTGTCAGGTCAGTCG
GCGTCCGCGAGACTGCCGT -> CGTCCGCGAGACTGCCGTT
TTAACAATGATGAGTGTTG -> TAACAATGATGAGTGTTGC
TATAGCACGGATCGACGCA -> ATAGCACGGATCGACGCAT
TTAATTAGGAGCCAACGGC -> TAATTAGGAGCCAACGGCC
CGAATTCGGCATCGAGGCT -> GAATTCGGCATCGAGGCTG
GCCCACGGCCAGTATTATG -> CCCACGGCCAGTATTATGT
TAGCAATCGACATGCACGC -> AGCAATCGACATGCACGCA
TAATGTGACTCTGGGTAGC -> AATGTGACTCTGGGTAGCC
TGCAGGAATCTGCCAGCTC -> GCAGGAATCTGCCAGCTCA
ACGGCTTAGTTGAAATAAT -> CGGCTTAGTTGAAATAATG
ATTCGGCATCGAGGCTGCA -> TTCGGCATCGAGGCTGCAA
TTCTGATGAGAAAAATTGA -> TCTGATGAGAAAAATTGAT
TAAATCATGCGGGTTCCAA -> AAATCATGCGGGTTCCAAA
CGTGAGCAAGAATCATAAA -> GTGAGCAAGAATCATAAAG
TGACTAAGTCGTTCGCAGA -> GACTAAGTCGTTCGCAGAG
TCAGTAGGACATACGGACA -> CAGTAGGACATACGGACAG
GGATGGGCCGGATTCGTTA -> GATGGGCCGGATTCGTTAA
TCTGGAAATCCGTGAGCAA -> CTGGAAATCCGTGAGCAAG
TGTGGGATTAGAGGTGGAT -> GTGGGATTAGAGGTGGATG
GATATTGTACCTATGGACT -> ATATTGTACCTATGGACTT
TACGGACAGAATACGCGAT -> ACGGACAGAATACGCGATC
CGTCCCGCTCCTGTGTGAA -> GTCCCGCTCCTGTGTGAAG
GGAATATACGCTTCTCGCT -> GAATATACGCTTCTCGCTT
TATACGCTTCTCGCTTAGT -> ATACGCTTCTCGCTTAGTT
TCTTAAGGTCGGGTAACGT -> CTTAAGGTCGGGTAACGTC
ATGATTGCCGCAAAGAGGG -> TGATTGCCGCAAAGAGGGC
TTAGTTGAAATAATGTGAC -> TAGTTGAAATAATGTGACT
AGTGACGAAGGAGTATATA -> GTGACGAAGGAGTATATAA
GTTCAGGAAGAAGGTCAAA -> TTCAGGAAGAAGGTCAAAG
GTTCCTGTTGCTTAAGAAC -> TTCCTGTTGCTTAAGAACA
ATCACCCGTCGCAATTTAC -> TCACCCGTCGCAATTTACG
TCGTCCCGCTCCTGTGTGA -> CGTCCCGCTCCTGTGTGAA
AATGCAGGAATCTGCCAGC -> ATGCAGGAATCTGCCAGCT
CGGGTTCCAAAAGGCTCGT -> GGGTTCCAAAAGGCTCGTC
CCATTATATAGCAACCAAC -> CATTATATAGCAACCAACT
ATGTACCGTAACGAATCCC -> TGTACCGTAACGAATCCCA
TCAGCTCTCTTAAATCGGG -> CAGCTCTCTTAAATCGGGG
ACGGACAGAATACGCGATC -> CGGACAGAATACGCGATCC
CGCTTAGGTTGGAATAGTT -> GCTTAGGTTGGAATAGTTA
CGTATTATGTACCGTAACG -> GTATTATGTACCGTAACGA
GTTTATACAAGAATCATAA -> TTTATACAAGAATCATAAA
CGATCCCGTAGAATGGTCC -> GATCCCGTAGAATGGTCCG
AGACTGGGTACAAGAGGTT -> GACTGGGTACAAGAGGTTG
CTATAATGATTGCCGCAAA -> TATAATGATTGCCGCAAAG
GTGGGATTAGAGGTGGATG -> TGGGATTAGAGGTGGATGC
GGTGGAACTCATTAACAAT -> GTGGAACTCATTAACAATG
TACCATTGAGCTCCATGAG -> ACCATTGAGCTCCATGAGC
CCTGTCGATCAGCTATGAT -> CTGTCGATCAGCTATGATC
GGATAAGTTTTCGATTCCA -> GATAAGTTTTCGATTCCAC
ATGATAGTCGGATAGCCCC -> TGATAGTCGGATAGCCCCG
AAGCGTGTGATGGTTTTTC -> AGCGTGTGATGGTTTTTCT
CGCTGTAGGACCGTATTAT -> GCTGTAGGACCGTATTATG
TATGTACCGTAACGAATAA -> ATGTACCGTAACGAATAAA
GCTGCAATGTGCGCATAAC -> CTGCAATGTGCGCATAACG
TAATTACCGTGGGAGAACA -> AATTACCGTGGGAGAACAA
ATAGTTAGTTTGCAGTATC -> TAGTTAGTTTGCAGTATCA
TATAGAGAACCGTCTCGTA -> ATAGAGAACCGTCTCGTAG
GCAGGTCCGTGTAAACACA -> CAGGTCCGTGTAAACACAT
ACGGTTATTCTACCATTGA -> CGGTTATTCTACCATTGAG
ATCGGGTTATCATTAGCAA -> TCGGGTTATCATTAGCAAT
AATCAATCAACGGATCCGC -> ATCAATCAACGGATCCGCG
AGGGTTCCTGTTGCTTAAG -> GGGTTCCTGTTGCTTAAGA
ACTTCTCTCTCGCCCGGGG -> CTTCTCTCTCGCCCGGGGA
GGCCAGTATTATGTACCGT -> GCCAGTATTATGTACCGTA
GTGTGAAGCGTGTGATGGT -> TGTGAAGCGTGTGATGGTT
AAGGTCCCCACTCTGGAAA -> AGGTCCCCACTCTGGAAAT
ACTCTGTAGCACGTAGCGT -> CTCTGTAGCACGTAGCGTT
AGCATCACACCGCATCTTG -> GCATCACACCGCATCTTGC
AGAATCATAAAGTCGCTGT -> GAATCATAAAGTCGCTGTA
ATCAATCAACGGATCCGCG -> TCAATCAACGGATCCGCGC
TATGGTCACCACGATAATT -> ATGGTCACCACGATAATTC
